_____________________________________________________________________________________________________________________________________________
|  _   _  | |  _____________   _  |___  |  ___    |    _  |_    |_  |  _____  |  _________  |  _  |  ___   _|    _____|  ___   _   _____|   |
| | | |_____| |  ___|  ___  | | |___  | | |_  | |_| | |_______|_  |___  |   | |_____  |   |___| |___|_  |_____|_____  | |_  | |___|  _____| |
|_  |_________| |  ___|   | | |    _|_  | |   |_____|_________  |___  | | |___  |_  | | |_   _|    ___  |   |  _____  |___  |_______|  _____|
|  _|    _  |_  | |_   _|_____|_|  _____| | | | |  ___    |   | |   | |_| |  _|___  | |___|_____| |_  |___| |___  |  ___|  _|_   _  |_____  |
|_  |_| | |_  | |_  |___  |  _  |_|   |  _| |_  | | |  _|_| |___|_| | |  _|_   _|  _| |  _____  |_  |  _____|   | |_|  ___|   |_  | |_   _| |
|  _|  _|   |_  |  _|_____| | |_____| | |___  |_| | |_  |  _|  _____| | |    _|  ___| |  ___  |_____|_  |___  | |_  | |  _  |_____|___  |   |
|_____|  _| |  _|___________|  _|   | |___  |_______|   | |_____________| |_______|  _| |   | | |  _  |_______|_  |___|   |_|  _____  |_| | |
|  _   _| | | |   |  ___  |   |  _|_  |_  |_______  | |_|_   _____  |_  | |_  |  ___| |_  |_| |  ___|  _   _|  ___|_____| |  _|___  |_____| |
|_|  _|  ___|___| |  _  |  _|_| |___  |  _   _____| | |   |___   _| |  _| |  _|___  |  ___|  _| |   | |  _|  _|_   _____  |_____  |  ___  | |
|  _|  _|_    |  _| | | |_|  ___|   |___|___|   |  _| | | |   | |  _|   | | |  _____|_  |  _| | | |___| | |___  | |  _  |___  |  _| |   | | |
| | | |   | |_|_  |_  | |  _|  ___|_  |  _____| | |_  | |___| |_|_  | |_____|___  | |  _|_  | | |_  |_________|___| | | |  ___| |  _|_|___| |
| |_____|_  |  ___| | | |_  |___  |   |_  |_  | |_  | | |_  |___  | |___|  ___  | |  _| |  _| |_  |___  |  _______  |  _|_  | | |  _  |  ___|
| |  ___  |_| |_   _| |  _|    _| | |_  | |   |_______| |  _|  ___|___  | |   |___|_____| |  ___|___  |___|_    |  _|_____|_  | |  _| |_  | |
| | |  _|_____|  _|  _|_  | |_|  _| |___| | |___  | |  _|_  |___  |   | |___| |  _____  | |  _    | | |_   ___|_|_____  |   | | |_|  ___| | |
|  _|_   ___  |  _____|  _|_____| | |  ___| |_____  | |_     ___|___|___  |  _| |  _  | | | |  _|_  |_  |   |     |   |___|  _| |  _|   |_  |
|___  |_  |___|_  |   |_   _____  | | |_________  | |_  | | |  _   _  |  _| |_  | | | |___| |___  |_  | |_|___| | |_| |   |_  | |_  | | |  _|
|_  |_  |  _______| |_  | |_   _| |___|  _____  | |___| | |_|_  |_  |_| | |_____|_  |_______|_  | |  _|_________| |  _| |_  |_|   | | | |_  |
|  _|  _|_____|  ___|  _|   |   |_  |_  |  _  | | |  ___|  _  |_  |_____|   |_   _|___  |_   ___| |_  |___   _  | | |  _| |_  |_| |___|  ___|
|   | |    _  | |  _| |___| | |  _| |  _|___|___  | |_______|  _| |_   ___|_  | |  _  |_  |   |  _| |___  | | | | | | |   | |_  |  _  | |   |
| | | |_| |_____|_  |_______|_| |  _|_  |  _  |  _| |  ___  | |  _|  _|___  |  _| | |_____|_| | |_   _______|  _| | | | |_   _| | |  _|_| | |
| |___|  _|  ___  | |    ___  | |_____  | | | |_|   |_  | | | |_  |_____  |  _|  _|    _____  |_  |_|   |_____|  ___| |   |_|  _|_|_______| |
| |_____   _| |  _| | |_  |  _|___    | | |___  | |_  |_  | |  _|___   ___|___|_  |_|_    |_____|_____|_________|  ___|_|_____  |  _______  |
|_____  |_____| | |  _|  _|___  |  _|_| |___  |___|  _|  _| |_   _____|  _____  |___  |_|  _____     _|   |  _  |   |  ___  | |___| |    _| |
|_  |  _|   |  _|___|  _|   |_____|  ___|_  |_  | |_  |_  |_  |_  |   |_  |   |  ___|_  |_|  _  | |_|  _|___| | | |___|  ___|  _  |  _|_____|
|  _| |  _|___|    _  |  _|_  |   |_  |  _  |  _|_______| | |_  |_  |___|___| |___  |  _|  _|  ___|  _| |   |  _|_____| |_______| |_______  |
| |  _|_  |  ___| |___| | |   | |_  |___|  _| |  _____  |___  |_  | |    _  |_  | |___| |   |  _|   |_____|_________  |  ___  |  _|    _|  _|
| |_______| |  _| |  _____| | |_  |  _|  _| |___| |  ___|  _____| | | | |___  |_____  |_  | | |  _|_|  _____  |    _| |_|  ___|_  | |_____| |
|  _|  _____| |  _| |  _   _|___| |_  | |_   ___  |_______| |  ___|_| |___  |_____  |_  | | |_|_  |  _|  _|   |_|_______  |  _  | |_____  | |
|   |_  |_    | |  _| |_  |  _  | | |___|   |   |_   _______|_____  |___  |_  |_   _| | |_|    _|___|  _  | |_|  _  |  ___|_  | |  _|   | | |
|_| |  _|  _|_| |_  |_  | |_  | |_  |   | |_| |_  |_|  ___  |    _|_  |  _| |_  | |   |_  |_|___  |  _|   | |___| | |_|  _____| |_____|_  | |
|  _| |   |   |___  | | |___| |_____| | |___  | |_  |  ___|  _|___  | |_  |_  | | | |_  |_____  | | |  _| |___    |_____|_    |_______  |___|
| |  ___|_| |___  |___| |   | |  _____| |   |___  |___|   |_  |   | |  _|___  | | |_  | |  _____|___| | | |  ___|_  |_     _|_   _____|___  |
| | | |  ___|   |___  |___| | |  ___  |___|___  |_____| | |_  | |_  |_________| |___  |_|_  |    _  | |___| |  _____  | | |_  | |   |  _  | |
|  _| | |  _| | |  _______  | |_  |  _|  _____|___  |  _|_  | | | |_______  |  _|_____|   | | | |  _|_    | |_|   |  _|_| |  _| | |___|   | |
|___  | |_____|___|   |  _| | |_  |_  | |  ___    |___| |  _|_| |   |  _  | |___________|___|_| |___  |_| |_____| |___  | | |  _|_  |   |_| |
|  ___|_____  |  ___| |  ___|_  | |  _| | |  ___| |_    | |  ___| |___|___| |___   _  | |    ___|  _|_  |  _    | |_  |___|  _|  ___| |_|  _|
| |  _|    _| |_  |  _|_  |  ___|_| |   | |_  |  _|  _| |___| |  _____  |  _|  ___| | |___|   |  _______|_|  _| |_  |_______|  _|   | |  _| |
| |_____|_  |_  | | |   |_|_________| |___|  _| |  _|  ___|   |_  |_  |___|___  |  ___|   |_| |_  |   |   |_  | | |_______  | |___| | |_  | |
|_  |  ___  |  _| | | |___  |  _   _| |   | |_____|___|  ___|_  |_  |  _  |  ___| |   | |_  |_  | | |___|_____|_  |  ___  | | |  _  |_  | | |
|_____|_____|_____|_______|_____|_______|_|___________________|_______|_____|_______|___|_______|___|_______________|_____|_____|_____|_____|
