_____________________________________________________________________________________________________________________________________________
|  ___   _|   |    _   ___|    _____|     |   |_   ___  |  _  |  ___   ___  |   |  _    |_    |_    |_   ___   _______  |    ___  |   | |   |
|_|   |  ___|___| | | |  ___| |  _____| |___|_  | |  ___| |  _| | |  _| |  _| | | |  _|_  | |_  | |_  |_  | | |___   _| |_|_  |  _| | |_  | |
|  _| |___|  _   _|_  | |  _| |_  |   | |_______  |_|  ___|_____| | |  _| |  _|___|_  |  _|   |___| |_  |___|___  |   |_  |  _|_____|_  |_| |
|   |_______|___|   |_|_  |  ___|___| |_______  |_|  _|  _|  ___  | |_____| |  _   _| | |___| |  _  |  _|  _  |   |_|_   _|___  |  _  |_____|
| |_  |  _  |  ___|___  | |_  |  _____|_   ___|_  |_  |_____|    _|_________|___| |  _|_  |  _|   | | |___  |___| |   | |  _  | | | |_____  |
| | |___| |___|  _  | | | |  _|___  |  _  |  _  |   |_____  | | |  _________    | | |_   _| | | | |_|_  |  _|  ___| | |___|  _| |_  |   |  _|
|_  |___   ___|   | | |___|_____  | | |___|   |___|_   _|  _| |_|  _|  _______|_  |_  |_____|  _| |  _____|_____|  _|_  |___  |_  |___| |_  |
| |___  |   |  _| |_   ___|   |   | | |   |_| |  _  |_|  _|_______|  _|_   _   _| | | |___  | |  _|_  | |  _  |  _|   |_  |  _________| |   |
|_  |  _| | | | |_  |_|  ___|___|_| | | |___  |_  |_  | |  _____  |_  |  _|___|  _| |___  |___|___  |_  |_  |___| | |_____| | |  _______| | |
|  _|_  |_|  _____|_  |_________  |_  |_  |_____| | |___|  ___  |_   _|_   _____|   |  _| |   |   |_  |_  |_  |   | |_   ___| | |_  |  ___| |
|_   _|_  | |  _______________  | |  _| | |  _____|   | |_  | |_  |_|   |_  |  ___| |_  | | |___|_  |_____  | |_| |_  |___  | |_  | |_  | | |
|  _|   | |_| | |  _   _|   |  _|___|   |___|  ___  |  ___| | |  _|  _|_  |___|   |_   _|___| |  _  |  _  |_|_  | |  _|___  |  _|_  |  _|___|
|_  | | | |  _|  _| | |  _|___|  _____|___  |_  |  _|_|  ___| |_____|   |___  |_|_____|  ___  |_  |_| | | |  ___| | |  _  |___|  ___|_____  |
|  _| |___| |  _|_  |___|   | |  _  |_    | |  _|_____________  |  ___|_____|___  |  ___|_  |_  |_  |_  | | | |   |___|   |   | |   |   |   |
| |  _|_   _| |   |  ___  |___|_  |_  |_|_  | |_  |  _  |  _  |_  |  _  |  _  |   |_  |_   _  |  _|_____|___|___|  _|   |_| |___| |___|___| |
|  _|   |_  |___| |_  |  _|  _____| |___  |_|_  | |_  |___| | |___| | | | |_____|_  |_  |   |_|_____    |  ___  |_  | |_|  _|_  | |  _  |_  |
|_____|_  | |_  | |  _| |  _|_   _  |  _|___  | |   |_  |   |___  | |  _|___  |  ___| | |_|_   ___  | |___|   | |   |_  | |    _|_____|   |_|
| |   |  _| |  _| |_|  _|___  |_  | | |  _   _|_  |___| | |_____|___|___  |  _| |  _  |___  | | |   | |   | | |  _|_|  _| |_| |  ___  | |_  |
|___| | |  _|   |_  |_  |  _______| | | |___|  ___|    _|___________________|  ___|___  |  _|___| | |___|___| |_|   |_____|  _| |_   _|___| |
|   | | |   | |_  |_  |_  |  _  | |  _|_________  | | |  _______  |  _  |_  |  _|   |___|_  |  ___| |_____  |_____| |  _____  |_  |_____  | |
| |___| | | |_  |  _|_  |_| |  _| | |  _  |   |___| |_| |  ___|  _| | |_  |  _|  _|_____  | | |  _|  _____________|___|  ___  |  _|  _  | | |
|   |  _| | |_  |___  |_____| |  ___| |_____|_  |   |  _|___  | |  _| |  _|_  | |_____  | |___| |  _|  _  |  _______  | |_____| | |   |_| | |
| |___|_  |_  |_|   |___  |  _|_____|_  |    _| | |_| |   |  _|_______| |_____|_______  |___   _| | |_  |___|    _|  ___|  _  | |_  |_  | | |
| |     |___|  ___|___  | |_________  | |_|_   _|_______| | |  _____  |_   _   _|    _| |   | |  _|_  | |  ___|_____|  ___|   |_  |___|  _| |
| |_| | |   |_   _____| |  _____  |  _| |   |___  |  _  |___|   |_____  |_  |_____|_______| |___|   | | |___|  _______|    _|___| |   |___  |
|_  | |___| | | |  _____|_|    ___| |  ___|_  | |___| |___  | |_____  | |  _| |  ___  |   | |  ___|_  |_______|___    | |_|  _  |___| |_   _|
|  _|  _  | |  _|_  |  ___  |_|  ___|___|  ___| |   |   |  _|_  |_  | | | |   | |  ___|_| | |___  | |_  |  _________| |_____| |_    |_  |_  |
| |  _|  _| |_____| | |  ___|  _|  ___  | | |  ___|___| | |_  |_  | | | |___|_| | |_    |  _______|  ___|_  |___   ___|___    |  _| | | |_  |
| |_|  _| | |  _____| |___|  _____|_  |___| | |_  |  ___|_  |_______| |___  |  _|_  | | |_  |  _  |_  |    _|   | |_    |  _| |_  |___|_  | |
| |  _|  ___| |  _|  _______|  ___  |  _____| |   |___    |___________|  _| |   |  _| | |___| | |_  | | |_|  _| |_____| | | |_  |___   _| |_|
|___| | |___  |  ___|  _______|  ___|  ___  |___|  _|  _| |     |_  |  _____|_| | |_  |_  |  _| |  _|___|  _| |_____  |___|___  |  _|_  |_  |
|  _  |_  |  _|___  |_  |     | |   | |_  |_  |  _|  _|___| | |_  | |___________|_  | | |___|  _| |    ___|_    |   | |  ___  |___|  _   _| |
|_  |_|  _|   |_______| | | |_| |_|_______  |___| |_  |   | |_  |___  |  ___   ___| | |  ___  |  _| |_____  | |___|_|___|_  |_______| | |  _|
|   |  _| | | |   |  ___|_|   |_________  |_______  |___| | |  _|_____| |   |___  |___| | |  _| | | |___  | |___  |  ___   _____|    _| | | |
| |_|_  |_  |___|_  |_    |_|___    |   | |_  |  ___| |  _| |_______  | |_| |  ___  | | | |_____|  ___  | |_  |  _| | |  _|  _  | |_____| | |
|_    |_  |___|   |_____|_  |  _  |_| |___|   |_  |_  |_____|___  |  _| |   |___  |_  |_  |  _  |_|   |_   _| | |  ___| |  _|   | |  _  | | |
|  _|_|  _|  ___|___  |  _____|___|  _|    _|_  | |   |   |   |   |_____| |___|  _|  _| | |_  |_  | |_  |_|  _| | | |  _|  _| | | |_|   |_| |
|  _  | |  _| |  _  | |___|  ___  |   | | |_____|___|___|___|___|___  |  ___  | |_____  | |  _| |___|  _|  _|  ___| |_____|  _|_|_  | |_  | |
|_  |___|_  |  _|  _|___  | |  ___|_| | |_  |  _  |  _____   ___|  ___|_|   | | |   |___| | |   |  ___|  _|  _|  _  |  _____|   |  _|_  |_  |
|___________|___|___________|_________|___|_____|_________|_______________|___|___|_________|_|_________|_______|___|_________|_________|___|
