_____________________________________________________________________________________________________________________________________________
|  ___   _____  |  _  |     |  _______  |  _____   _|    _____|    _____  | |  _  |  _   _|    _________  |___    |  ___________   _____  | |
|___  | |  _  |___|  _| | |_| | |  _   _|___  | |_____|_  |   | |_  |   |___|_  |_____|___  | |   |  ___________|_|_  |___   _|  _|  _  | | |
|  ___|_|_  |_  |___|  _|_____| |_  |_|   |  _|_    |   |___|___| |___|_  |  _______|  _  |_| | |_| |_   _|  _________|   | |  _|   |___| | |
|  _  |   |_  |___  |_________  | |_  | | |___  |_| | |  _  |_______    | |_  |  _  | | |_____|   |  ___|  _|   |  ___  |___| |  _|_  |  _| |
|___|___|_  |_  |  ___  |  _  | |   |___|_  |  _|  _| | |_________   _|_|_  | |_  |___|  ___|  _|___|   | |  _|___|   | |  ___|_|   | |_  | |
|  _____  |_  | |_  |___| | |___| | |_  |   | |_____  |_  |_______  |  _  |___| | |    _|   | | |  ___| | |___   _| |_  | |  _  | |___|  _| |
|   |   | |   |_  | |   |___  |  _|_   _| |_| |  _  |_  |_  |  _  |_| | |  _____| | | |  _|_____| |  _| | |   |_|  _|___| | | |_  |  ___|_  |
|_| | |___| |_|  _|___|_    |___|   | |  _|  _| | |_  |_  | | | |_  |_  |___  |  _| |_|_  |  _____|_  |___| |_   _|  _____| |_____|___  |   |
|  _|_  |_____   ___|   | |_   ___|_| |_  |_____|   | |___|___  |  ___|_   _| |_  |  _  | |___  |  _  |_    |___|  _|  _|  _____   _  | | | |
|___  |_  |   | |  _  |___|___|  _  | |   |  ___  |_|_______  | |___  |  _|  _  | |_  | | |_  | | |___  |_|___  |_  | |  _|  _  | | |___| | |
|  ___| | | | |_| |  _|  _______| |___| |_| |   | |  _________|___  |___|  _|  _|_  |_|_   ___| |___  |_________  | |_____| | | |_____  | | |
|   |___   _|_____| |  _|___   _  |   |_____| |_| | |___     _|  ___| |  _|  _|_  | |   | |   |_______| |  _______|_  |   |_  |___  |_____| |
| |___  |_|  ___  |_| |  _  |_  | | |___  | |   |___|   | | |  _|___  | | |  _____|  _| |_| |_____   _____|  ___   _|___|_  |___  |_  |_  | |
|_  | |_____|   |_____|_  |_  | | |_  | | | | |  _____| | |_| |_   ___| |  _|  _  | | |___  |  _  |___  |  _| |  _|  ___  |_____  | |_  |  _|
| | |___    | | |  _|    _|  ___|_____|  _|  _|_____  | |  ___|  _|  ___|_  |_  | | | |   |_|_  |_  |_____|  _| | |___  |_____  |_  | | | | |
|  _|  ___|___| |_____| |___|  _____  | |___|  ___  | | |___  |   |_  |  _____| | | | | |_______| |_____  |_________  |_  |  _| |  ___| | | |
|_  | |_   _  |_____  |  _____|    _| | |   |_  | |___| |   | |_| |  _| | |   | | |_  | |_   _______   _|___  |   | | |___|  ___|___|  _|_  |
| | |_  | | | |    _| | |   |_  |_|  _|___|_____| |   | |_| |_  | | | | | | |___| |  _|_  |___  |  _|_   _  |___| |_______| |   |  ___|  ___|
| | |  _| | |___| |  _| | |_  | |  _|  ___    |  ___| |_  |  _| | | |_____| |   | |  ___| |   |  _|  _  |_____  | |  ___  |___| | |   |  ___|
|  _| |___  |  _| |_  |___| | | | |___|   |_|_____|   |  _|  _____|_____  | | |___|_|  ___|_|_  |  _|  _|  _  |_|___|_  |_______|  _| |_|   |
| | |   | | |   |  _| |  ___|  _| |  ___|___  |   | |_|_  |___|   |   |   | |_____  |_  |  _  |_| |_____|_  |___   _   _____|  _____|_   _| |
| |___| |  _| | |_____|  _____|   | |  _  | | | |___|   |_  |  _|___| | |_| |_    |_  | | |___  | |  _    | |  _|_  | |  _____| |  _  |_  | |
|___  | | |___|___   ___|   |  _| |___|  ___| |  _  | | |  _| |___   ___|  _|  _|___|___| |   |___|_  | |_| | |  ___|_|_  |    _| |___  |_| |
|  ___| |_______  |_|  ___| |_  |_  |  ___|  _|___|___|_______|   |_|   |_  |_  |  ___  |  _| |  ___  | |  ___|_______   _|_| |  _|   |___  |
| |___   _____  |_____|   |_____|  _| | |  _|  _  |  _  |   |  _|_____|   |_  | |_  |   | | | | |   |_|_____|   |  _  | |   | |_  | |_  |___|
|___  |_|  _____| |  ___| |   |  _| |_  |_____| |___| |___| |_  | |  ___|_  | |_   _| |_|_  |___| |_____  |  _|___| | |_  |_____| | | |___  |
|   |_____|  ___|  ___|  _| |_____  |  _|   |  _   _  |  ___  |_  |_____  | |_  |___|    _|  ___| |  ___|___|  _|  ___|  _|  _____|_   _|   |
| |_  |   |   |  _|  _  |  _| |   |_|_  | | |_  |_  |_|_  |___|  _|   | | | |  _|   |_|_____|   | |  _   _|  _  | |___  |  _|   |  ___|  _| |
|_  |___|___|_____| | | | |  _| |_______|_|___  | |_   _|_______|  _| | | | | |   |___________|___| | |_______| |___  | |_____|___|   | |  _|
| |_  |_  |     |  _|  _| |   | |   |  _____  |_  |  _|  ___     _|___  | |_| | |_____  | |  ___  | |     |  _____  | |_________|  _|___|_  |
|  _| |  _| | |_|_  | | | |_| | | |___|  _  |_  | |_____|   |_|___  |  _|_____| |  _____|_  |   |___|_| | |_  |___  | |  _____  |   |_    | |
|_  | |_____| |  ___|_  |_  | | |_  | |_  |   | |_____|  _|_  |  ___|_  |_   ___| |  ___  | | |  _______|  _|___  |_|___|  _|  _| | |  _|_| |
|  _|_   _____| |  _|  _| | | |_____|  _| | |_|_  |  ___|   |___|  _  |_  |___|  _|___  | |_  |_|  _  |___|  _  |_  |  _______| | | | |  ___|
|  _____|  _____|   | |_  | |_   _|   |  _|___  |___|   | |_______|   | |___  |___    | | |___|  _| |_  |  _|  _____|_____  |  _| | |  _|   |
| |  _  | |___   _| |_   _| |  _|  _| | |   | |___  | | | |___  |  _| | |   | |   | | | |___  | |   | | |_  |_|  _____    | |_____| |_____| |
| |_  | |___  |___|  ___|  _|_____  | |  _|_____  | | | | |  ___| | | |___| |___| |_| |_  | |___| |_  |_  | |  _|_  |  _|_|_____  | |   |___|
|_  | | |   |___  |_   _|_  |  _  |_|___|  ___  | | | | |  _|  ___| |_______  | |_  |___  |___   _|_   _| |  _|    _|___    |   | |  _| |   |
| | | | | |___  | |___|   | | | | |  _____| |  _| |___|___|  _|  _____|    _| |   |___  |_______|   |_|  _| |  _| |  _____| | |___|___|___| |
| |___| |_|  _  |_  |  _| | | | | |_  |   |  _|_______|   | | |  _  |  _| |  _| |___  |_____  |  _|_  |_  |___|  _|_  |_____| |___   _____  |
|___________|_____|_____|_____|_______|_|_______________|___|_____|_____|_______|___________|___|_________|_________|_______________|_______|
