_____________________________________________________________________________________________________________________________________________
|_  |  _     _|  _  |   |   |  ___   _  |  _  |  _   _________|   |  _____   _____  | |  _______   _____|  _   _  |  ___|    _|   |  ___    |
|   |_  | |_|  ___| | |___| |  _|  _|___| | | | | | |  _  |  ___| |_____  |___  |___  |_  |     |_________|  _| | |_____  |_  | |___| |  _|_|
| |___| | |  _| |  _|___  |___|  _|   |  _| |_____|___  | | |   |___   _| |_  |_  |  _| | |_| |_|  _____  | |   | |  _  |___|___  |  _|___  |
| |  ___| |_  | |_   _|  _|   |   | | |_  |_   _|   |___| |___|___  |_____|   | | | |  _|_  | |  _|___  |___| | | | |_________  |___|  ___  |
| |_  |   | | |   |_____|  _| |_|_  |   |_  |_  | |___  |_  |  _____|   |  _|  _| |  _|   |_  |_  |   |_   ___|___| |  _  |  _| |  ___| |  _|
| |  _| | | |___| |  ___|_  |___  |_| |_  |___  |___  |_  | | |___   _|_  |___|   |_|  _|_  |  _| | |_  |_  |___________| |_  | | |___  | | |
|  _| | |___|  ___| |  _  |_  | |_____|  _|  ___|  _|_  |___|___  | | |  _|  ___| |  _|_  |___|  _| | | |_________  |  ___|  _|___|    _|_  |
| |   |_______|   | | |_______|    _|  ___|_  |_____  |_  |  _______| |  _|_  |___| |  _  |_  |_  |_  | |  _____  | |___  |  _  |   |_|  ___|
| |_|_   ___  | |___|_  | |  ___|_  | |  _____|   |  _|  _| |   |   |_  |   | |  ___|_  |_______|_____|___|_  |  _|___  | |___| | |_____|_  |
|_______|   | | |  _  | |  _|  _  |___|_____  | | |_  |_____| | | |_  |_| | | |_____  |  ___  |  _______   ___| |___   _|_  |  _| |  ___  | |
|  ___|  _| |_  | | | | | |  _| |_____  |   | | |___  | |  ___| | |_______|___  |   | |___  | | |  ___  |___  |___  |_______|_   _|___  |_  |
|  _____|  ___| | | |___| |_______  | |___|___| |  _| | | |  ___|   |  _|  _____| |_|_  |  _|_____| |  ___|  ___  |___    |   |___  |  _|___|
|___  | |_______| |_____  |_   _  |_  | |    ___|  _____| | |   |_| |   |_  | |  ___  | | |   |_  |  _|   | |  _| |   | |___| | |  _|  ___  |
|   |___  |    _|_____  | |   |___|  _|___| |  ___|_  |  _|___|_____| | |  _|  _|   | | |_| |_  |_____| |___|_   _| | |_  |  _|_  |_  |  _| |
| |___  | |_|___   _|  _| | | |   |_________|_  |  ___|_______  |  ___| | |  _|  _|  _|_  |_  |_  |  _  |  _  |___| |_  |_|_    |_  |___|   |
| |   | |___  |  _|  _|_____| | |_   _____|  ___| |  _  |  _____|_|   | | |___| |  _|  ___|  _| | | |  _|_  |_______|  _|   | |_  |___  | | |
|  _| |  _|  ___|  _|   |  _| | | |_________|  _______| |_  |___   _|___| |   | |_|  _| |  _  |  ___|_|   | |_   _________| |  _|___  |___| |
|___| | |  _| |  _|  _| |_____| |  _   _|   |_   _|  ___  |___  |   |   |___| | |  _|  _|_  | |_|   |  _| |   |___|   |_   _|_|  _____| |  _|
|  ___| |___  | |  _| |_________|___|___  |_____|  _|_____|   | | |___|_________|_  |___   _|___  | |_| | | |_______|_  | |   |_  | |   | | |
| |   |  _|  _|___|_   _|  ___   _____  |_  |_  |_  |   |  _| | |_|   |   |  ___  | |   |___|   |_|  ___| | |   |  _____|___|_____| | | | | |
| |_|  _|  _|  ___  | |  ___  | |     | | |___  | |___| | | | |_____|___|___|   | |___|___  | |___  |  ___|_| | |_  |  _   _|    _|  _| |_  |
|_  |___| |_____  | |___|   | | |_| | | | |   |___  | | | | |___   _____  | | |_   _____  | |  _  | | |   |  _|_  | |_  |_____|_  |  _|  _| |
|   |  ___|  _____| |   | | |_| |  _| | |  _|_____  | |___| |  ___|  ___| | |_  |_|   |  _| |  _| | |___| | |  ___|_  |___  |_  |___|  _|  _|
| |_|_  |  _|  _____| |___|_  | |_  |_| |  _|  _  | |_     _| | |  _  |  _|   | |  _| |___| | |  _|_|   | | |_____  | |_  |_____  | |_____| |
| |  ___|_  | |___________  | | |  _|  _|_|  _| | | |  _| |  _| | |  _|_  | | |___|  _|   | |_| |  ___|___|_  |   |___|  ___  |  _|_    |_  |
| | |_    | | |  _____  |  _| | |_  | |   |_  |  _|___|___| |___  | |  ___| | |_  |_____|_______| | |  _    | |_| |  _____  | |_______|___  |
| |_  | |___| |___  | | |   | | |   | | |_____|___  |  _  |___  | | | |___  | |   |_____  |  _____|  _|  _| |   |  _|  _  | |_______  | |  _|
|  ___|_  |  _|   | |  _|_| |___| |_| | |  _____  |___|  _|  ___|_| |_______|___|  _______|_  | |  ___| |  _|_| | |  _|  _|_______  |___| | |
| |_     _| |  _|___|_  |  _| |  _  | |___  |  _| |  ___|_  |    _  |   |  _   _| |  _________| | | |  _| |_   _|___|  _|_    |_  | |  ___| |
|_  |_| | |___| |    _| | |  _| |  _|_  | | | |  _| |_   ___| |_  |_| | |_  |_____| |   | |  _  | | | | |_____|   |  _|    _|___  | |_____  |
| |_____| |   |  _|_  | | |  ___|_    | |_____| |_______| |  _| |_____|_  | |_    | | | | | |  _|_  | |  ___  | |___|  _|_  |_   _|___  |  _|
|  _________| |___  |___| |_____  | | |_____  |_   ___  | | |    _____  | |_  | |_|___| | | |_______| | |_  | |___  |___  |_  |_|    _| | | |
| |  _|  _   ___|  _|  ___  |  ___| |_______|_  |_  |  _|  _| |___  |  _|   | |_    |  _| |  ___|  ___| |  _|_  | | |_____|   |  _|_  | |_  |
| | |  _|___|  ___| |  _|   |_____| |  ___   _| |  _|_  | |___|  _  |___| | | |  _|_| | |  _|  ___|  ___|_______  |___  |  _|_| |  ___|_  | |
|_  |___  |  _|    _| |   |_|  _  | | |_  |_____|___|  _|_______|  _|  ___| | | |  ___|___  | | |  _________  |  _|   | |_____  |_____  |___|
|  ___|   |_  |_|___  | |_|  _| | | |_  | |    _______|  _    | | | |_  |  _|_  |_______  | | |  _|  _|  _  | |_|  _| |_____  | |_    |_    |
|  _|  _| | |_____  |_|   |___  | | |  _| | |_  |     |_  | |  _|___  | |_|   |_  |  _____| | |_  |_______| |_____| |_________|  ___|___| | |
| |  _|  ___|  _  |_  |_|_______| |  _|   | | | |_| | | | | | |  _  | |_____|   | | |_    |_|_  |_______  |  _  |   |_   _|  ___|  _  |  _|_|
| | |_____|  _| |  _| |  _  |  ___|_  |_|_____| |  _|___| | |_| | |___|_    | |_| |_  | |_______| |    _| | |  _| |_  |_____|  ___| | |___  |
|_|_____________|_______|_____|_________________|_________|_______________|_|_______|___|___________|_______|_____|___________|_____________|
