_____________________________________________________________________________________________________________________________________________
|   |  _______  |  _________    |  ___  |_    |_    |_    |_   _  |_    |  ___   ___  |  _____   _|    _  |    ___  |   |_____   ___  |  _  |
| | | |  _____  |_  |  _    | |___|_  |_____|_____|_____|_____|  _|  _| | |   |_  |  _|___|   |_____| |  _|_|_  | |___|___  |  _| |  _|_  | |
| |_| | |  _______| | | | |_| |  _  | |    _   ___|  _____    | |___  | |___|___| |_________| |  _____|_________|   |  _____| |  _| |_____| |
|  ___| |  ___|   | |___|_  | |   |___| | |___|  ___| |   |_| |_______|_____  |   |___   _|  _|  ___  |___   ___  |_|_  |  ___|_  |_____  | |
|___  | | |  ___| | |  _   _| | | |   | | |   | |  _  | |___________  |  _____| |_|   | |  _|_  |  _| |   |___  |_|   |___|    _________|_  |
| |  _| |_| |   | |_  |___|  _| |___| | |___| |___|  _|_____  |_______|___  |_______| |_____  |___|  _| | |   |_____|_______|  ___________  |
| | | |_____|_| |_  | |  ___|  _|   | | |   |___  |  _____  | |  ___________|  ___  |_____  |_  |   |  _| | |_________  |   |_|  _______  | |
| | |___   _  |   | | |_  |___|  _| | | |_|_    |___|  _  |_| | |_______    |_  |  _|   |  _| |___| | | |___| |  ___  | | |_  | |_   _|  _| |
| |___  |   |___|_|___| | |   | | | | |_  |  _|___|  _| | |  _|_  |   |  _|_____|_  | |___|  _  |  _|___  |   |_  |___  | | | |___  |  _|  _|
|   |  _| | |  ___   ___|___|_____| |  _____|  _____|  _|_  |  ___| |___|_______  | | |_______|_____|  ___| |_  | |   |_| | |_______| | | | |
| | | |___|  _|_  |_______  |  _____|_  |   | |  _   _|  ___|_  |_______  |  _____| |  _  |   |  _____|   |___| |___|_________|   |  _| | | |
| |_|___  |_   _____|  _____| |  ___  | | |___|_  |___________| |  _______| |  _____|___|_  |___________|_______  |  ___________|___|  _| | |
| |  _  | | | |  _  |_  |  ___|___  |_| | |_  |  _|_  |  _  |  _| |___   _|  _|  _   ___  |___|   |  _  |  _|  ___| |_   ___    | |  _  |_  |
| |_  |___|___| | |___  |_______  |_  | |_  |_  |  _  | | |___|  _|  ___|  _|___|  _|  ___|  ___|___| | |  _____  |_  |___  | | | | | |_  | |
|  _|___  |    _|_   ___|   |_  |_  |_____|_  |  _|___|_____  | |  _|   |_________| | |  ___|___   ___| | |   |_____|_  |___| |___|_  | |___|
|  _______| |_|   |_  |_  |___  | |_____  |  _| |  _______  | | | |  _|___   _|    _|___|    _  | |  ___| | |_____  |  _|  _  |    _| |  _  |
|_____  |_____  | |_______|_  | | |     | | |___|_  | |  ___|___| | | |  _  |  _|_________|_  |___|___  | |_  |_______|  _|___| |_____|___| |
| |   | |  _  |_|_  |_____   _| |___| |_| |___________|___     ___|_  |_  |_| |  _   _____  |_  |   |  _|___|_____  | |  _______|  _______  |
|  _| |___|  _|  ___|  ___| |  ___  |   |_____  |  _____  | |_|  _____| | |  _|_  |_  | |  _|  _| |___|_   _________| | |   |    _|___    | |
|_|  _|  ___|___  |  _|  _____|   | |_|  _|   | | | |  ___| |  _|_   ___|___|   |___| | |_  |_____|  _  | | |   |     | |_|___|   |   | |___|
|  _|  _|    _  | | |_  |   |  _| | |  _|  _|___| | | |  _  |_  |  _|  _  |   |_______|  ___|___   _| | | |  _| | | |_|_____  |_|___| | |  _|
|   |_  |_| | | | |_  |___| |_  | | |_  | |  _   _| | |_  |___| |_____  |___| |_____  | |___    |_  | |___|___|___|    ___  | |  _____| |   |
|_|   | |  _|  _|   | |  ___| | | |  ___| | |  _| |  _____|  ___|   |_______| |   |  _|_  |  _|_____|___    |  _  |_|___  | |___|  _  | |_| |
|  _|_| |_  |_  |_| | |_______| | |_|  ___| | |   | | |   |_  |_  | |  _  |  _| |___|   | | |  ___  |  ___|___| |_________| |   | | |___|   |
|  _________|___  | |___  |  ___|_  | |___  | |_|_____| |_____|  _|___| |___|  _______|___| | |   | | |  _     ___________|___| |_  |  ___| |
|___  | |   |   |___|   | |_  |   | |___  |_|_    |  ___|   | |  _  |    _|  _|   |___   _|  _| | | | |___| |_|  ___   ___________| |  _  |_|
|  _| | | | | |_______|___|  _| |_|___  |___  | | |_  |  _| |  _|  _| |_|  _|  _| |   |  _______|_| |  _  |_____|   |_  |  _________|___|_  |
|   |  _| | |_  |  _   _  | |  _    | |_______| |  _|___|  _| | | |___  |_  | |  _| | |___|  ___  | |___| |   |  _| |___|_  |  ___  |  _  | |
| |___|  _| |  _|_|  _| | | | | | |_  |___   _| |_________| | | | |   |_  |___|_____|_______|   | | |   |_  |___| |_____  | |   | | | | | | |
| |  ___| |___|    _|   |___|_  |_  |___  |_  | |    _____|  _| |___|_  |  _   ___  |_   _|  _|___|  _|_  |_  |_______  |___|_| |  _| | | | |
| |_  |   |   | | |___|  _|   |_  | |  _|_  | | |_| |   |  _|_    | |  _|_  |_  |_______|  _|___________| | |_  |  _  |  _______| |  _| |_  |
|_  |___| | |_| | |   |_  | | |  _| | |  _____|_  | | |___|     |___| |  _____|___   _  |___  |  _____  | |  _| | | |___| |    _|___|     | |
| | |_  | |_  | | | |_  |___|___|  _| |_   _|  ___|  _|_____| | |  ___|  ___|  _  |___|___  |___| |  ___| | |  _| |  ___|  _|_________| |_| |
| |_  | |_  |___| | | | |  ___  |_  |_____|  _|   | |  ___   _|_|_  |___|  ___|  _|  _  |  ___|  ___|  ___|  _|  _|  _____|    ___|  _  |  _|
|_  | |_  |___  |  ___|_  |   |   |  _______|   |_| |   |___|  _  |___   _|_  |_____  | |_   ___|_   _|  ___| |   |_  |  _  |_|  ___|_  |_  |
|  _|_  |   |  _|_|  _  |_| | |_| | |   |   | | |  _|_| |  ___| | |   |_  |  _  |   | |_  | |_     _|_  |___  | | |_  |___|_  |_____  |_  | |
|     | | |_| |_   _| | |  _|_____|___| | |___| | |   | |_  |   | | |_  |___|  _| | |_  | |_  |_|  _  |___  | | |_  |___  |  _  |   |_  | | |
| | |_| |   |_____| |  _|   |  _    |  _|_|   |_____|_  |  _| | |___|  _|  _|_  | |_  |_| | |_  |_  | | |  _| | | |_  |  _| |  _| |_   _|_| |
| |_____|_|  ___  | |_  |_| | |  _|_|_______|_______  |_| |   |_|   | |_________|_  | |  _|  ___|___| | |_  |_______| |_____| | |_  |_|  ___|
|___________|_________|_____|_|___________________________|_|_____|_________________|___|_____________|_______________|___________|_________|
