_____________________________________________________________________________________________________________________________________________
|     |  _____  |     |  ___   _______________|  ___  |     |___    |    _|  _  |  _____   _|    _____  |_   _  |  ___   ___  |   |    _____|
| | | | | |  ___|_| | | |_____|  _____  |  _  |_  | | | | |___  |_|_  | |  _| |___| |  ___|  _|_  | |  _|  _|  _| |  ___|   | | | |_|_____  |
| | |___|  _|   |   |___|  _____|  _|   | | |  _|_  |___| |   | |   | |___|  _  |   | |  _______| |  _|  _|_____| | | |  _|___| |_  |   |   |
| | |_   _|_  | | | |  ___|   |_  |  _| |  _| |   |_   _| | |_| | | |_  |  _| | | |_|___|  ___  | | |___    |   | | |_______  | |_____|___| |
| |_  |___  | |___|_|___  | |___  | |___| |  _| |_  | |  _|_  |___|_  | | | |  _|_   _  |___  | | |___  | |___|___| |  _  | |  _|   |_   ___|
|_  |_  |  _|_  |  _______| |  ___|_______|   | | | | |___  | |   |  _|___|  _|_   _| |_  |  _|___|   | | |  ___  | |_  | |___|  _|_  |_  | |
|  _|   |_______|_  |  _____|_  |   |  _  |_|_____|_____|  _| | | |___  | |_____  |_______|_  |_____| | |_| |_  | |   | |_  |  _| |   |_____|
|_|  _|_|  _________|_  | |  ___| | | | |_________________|  ___| |   | |___  |  _|  _____  |  ___  | |_____|  _| |_|_  | |___|   | |_|  _  |
|  _|  ___|  _  |_    | | |___  | |_| |  _   _|    _|    _| |  _|___|___  |  _|_  | |  ___| |___|  _|_    | |   |___  |_____  |_| |_____|   |
| |  _|___  | |_  | |___|_  |  _|_  | |___|_  | |_____|_______|   |   | | | |  ___| |_  |  _|  ___|  ___| | | |  ___|___  | | |   |   |  _| |
| | |    ___|   |___|_   ___| |     |_____  | |_______  |  _|  _|___| |  _|_____  |_  |_______|___  |_______| | |  ___  | |  ___|___|_|   |_|
| | | |_  |  _|_|    ___|  ___|_| |_  |  ___|  _  |  ___|_  | |___  | | |   |  _| | |_  |   |  _  | |  _  |  _| | | |   | |_  |  ___  |_|_  |
|  _|_  | |  _____|___________  |   | | |   |_  | |___  |   | |  _  | |___| | |  _| |  _| |___|_____|  _|___  | |_  | | | |___|   |_______  |
|_  | | | | |  ___|   |   | |  _|_| |_|___| |  _|___  | | |_|___|  _| |___  | |_  | |_  |_  |  _______|  _  |_|_____| | | |   |_|  ___  |  _|
| | |___| |___|  ___|___| | | |  _  |  _  | |_______|_____|  _  |  _| |   | |_______|  _|   |_  |  _  |_  |_____  |   |_| | |_  |___  | |___|
| |___  | |   |_____  |  _| | | |  _| |  _|___  |  _________| |___|   | | |___  |  ___|  _|_  | | |  _| | |   |  _| |_|  _| | |_  |___|___  |
| |   |_  | | |   |  _|_  |_____|_  | |_  |    _| |  ___   _______| | | | |   |___|    _| |  _|  _|_  | | | |_| |___  |_  | |_______  |   | |
|  _|_  | | | | |  _|   |_____  |___| |_____|_|  _|___  |_______  | |_| | |_|   |  _| |   | |  _|   |___| |  ___|  ___|  _|  _  |   |___|_  |
| |   |___| |  _|_|  _|_____  |___  |  _____  |___  | | | |  _  | |_____|_  |_|_  |  _|_|___| | | |_  |  _|_  |_  |  ___|  _|  _|_|___   _| |
|___| |    _|_|  ___|  _    |_  |  _|___|   |___  | | |_  | | |_______  | |___  | | |   |   |  _| |  _|   |_______|___  |_  |_______  |_  | |
|   | | |_|   | |_  |  _| |_|  _| |  _____|___  | | |_____| |_   _   _|_   ___| |_|___|___| | |  _|_  | |_________    | | |_  |_    |_  |___|
| | | |_____| |_  | | |  _|  _|_____|_  |    _|_  |_____  |   | | |_  |  _|   | |  _____  |  _| |  ___| |   |  ___  |_| |  _|_  |_|_  |___  |
| |___|_   _|_  | |___|_  | |  _____  |___|_______|   |  _| | | |   |_____| | | | |   |  _|___| |_  |_  | |_| | |  _|  _|  ___________|   | |
| |  _   _|   |_______   _|_______|  _|  _____  |  _|___|___| |___| |   |  _| |_____| | |  _____| |_  |___|  _|___  |_  | | |  ___  |  _|_  |
| |_  |_____| |   |_   _|  _____  | |  _|  _  | |___  |     | |   |_| |___| | |   |___| | |  _     _|___  | |  _  |_|  _|  _|_  |_____|  ___|
|_  |  _____| | |_  | |  _|  _  |_  | |  _|  _|_______|_| | | | | |  _|    _|___|_  |  _| |___| |_|  _  | |  ___|_  |_  | |   |  _  | | |   |
|  _|_|  _____| |  _| |_____|  _|  _|___| | |   |  _   ___|___| |___|  _|_|   |  ___|_  |  _  |_____  | | |_|   |   | | |_| | |___| | | |_| |
|___  | |  _____| |  _|   |  _| | |  _   _| | |_____|_  |   |  _| |  _______| |_________| | | |   |___| |_  | |___|_  |_____|___  | | | |   |
| |  ___| | |   | | |___| | |_  | | |  _|  _|  _|    ___| |___|___  | |   |    _________|  _|___|_  |  ___| |   | |  _____|  _  | | |  _| | |
| |_  |  _|  _|___|  _____|_  | | |_| |  _|_  |  _| |  ___|  ___  |_  | |_  |_|   |  _____|  _______|   |  _|_| | |_  |  ___| | |___| |   |_|
|  ___| |___  |   |_|  _  |  _| |_   _|___  |_| |___|___  | |_  | |_  | |___|  _|_______|  _|_   _____| |___  | | |  _|_  |  _|___  | |_|_  |
|_|    _|   |___| |  _|_____|    _| |  _  |_  |_   _    |___|  _|_  | |_  |  _|_   _|   |  _  |_____  | |   | | |  _|_  | |   |  _  |_____  |
|  _|_|  _|_  |_____|  _  |___|  ___|_  |_  |_  |_|  _|_|   |     | |  _|_____  | |  _| |_  |___  |___|_  |_____|_  |   | |_| |_  |___  | | |
| |  ___|  ___|   |  _| | |   | | |   |_  |_  |_  | |   | |___| | | |_|   |_______| | | |___  |  _|  _  |  _|  _  |___| | |  _  |___  |  _| |
| | |  _  |  ___|___|   |___| |___| |   |_  |_____|___|___  | | | |_  | |___  |  ___| |___  |_|   |_  | |_|  _| |_  |___|___|  _|   | | |  _|
|  _| | | | |   |_____|  _  |_______| |  _|___  |  _____  |  _| |  _|___|   |___| |  ___  |_  |_|___  | |  _|  _  |_____    | |  _|___|_|_  |
| | | |___|___|_________| |_______  | |_|  _____| |_    | |_|  _|_|  _____| |  _  |_  |  ___|_  |  _|_| |_  |   |_  | |  _| | |_  |  _______|
|_  |_______   _|  _____    |   |  _|_____|   |  _  | |_|_   _|  ___|  _  | | | |_____|_  |   |___|    _|  _|_| | | | | |___| | | |_  |___  |
| |___  |_  | |  _|   | | |_| |___|  _______|___| | |_______|  _|   |_|   |___|   |   | | | |_______|_  |___  | |  _| |___  |_  |_  |_  |   |
|___________|_______|___|_____|___________________|_______________|_____|_______|___|___|_____________|_________|_________|_______|_______|_|
