_____________________________________________________________________________________________________________________________________________
|   |_____  |  _    | |   |_   _  | |  ___   _|  _    |_    | |  _   ___|  ___    |_   _  |   |_____   _  |  _   _  |_    |  ___   _|  ___  |
| |___  |  _| | | |_  | | |  _| | | | |   |_____| | |_____| |_____| |  _______| |_  | | | | |_________|  _|_|  _| |  ___| |_____|   | |_  | |
|   |_  |_______| |___| |___| |  _|  ___|_______  | |    _|_  |   |  _|  _  |   |_____| | | |  _____  |_____  |_____|   |_____  |_| | |   | |
|_|_  |_  |    ___|  ___|  ___|_  |_|   |   | |  _| |_|  _  | | | |  _| |  _| |_|   |  ___|  _|_    |___  |___|  _____|_  |_  |_  |  _| | | |
|  ___|_____|_|   | |  ___|   |  _|  _|___| | |_  |_  |_  | | | | |_|  _|_  | |  _| | |  _| |   | |___  |_  |  _|  ___|  _|   |  _|_____|_| |
| |   |   |  ___|___|  _____| |_  |_  |   | |  ___| |_  |_|_____|_____|  _| |  _|  _| | |  _| | |_  |  _  |___|___  |  _|  _|_| |  _  |  _  |
| | |___| | |  _  |_________|   |_  | | |_| |_  |    _| |  _  |  _  | |  ___|_  | | | |  _|  _| | | | |_  |_    |   | |  ___  |___| |___|  _|
|  _|   | |___|___|  ___  |  _| | |___|_  | | |___| |  _|_  |___| | | |_  |_____| | | |_  | | | | | |_  |_____| | | | |_|  ___  |  _______  |
|_|  _| |  ___  |  _|_  |___|  _|_   _  | | |_  |  _|_____________| |   | |  _____|  _| |___| | | | | |_____  |___| |_  | |_____| |  ___  | |
|  _| | | |   |___|    _  | | |  ___|___  |_  |_____  |  ___________|_| | |   |   | |  _  |  ___|_________|  _|   |_|   |_________| |   | |_|
| | |  _| | |_______| |  _| | |___   _  |___|_  | |  _| |  _______    | | |_| | | | |_  | |_  |_   _______  |  _|  ___|_|  ___    | | |_|_  |
| | |_____|___|  _____|_  | | |   |  _| |  _  | |___|  _|_  |  _____| | |_____| | |_  | |_  |_  | |_________| |  _|   |  _|   | |_____|  _  |
| |___     _____|   |  _|_  |___| | |   | | |___|  ___|  ___|_____  |___  |   | |  _| | |  ___| |  ___  |  ___|_  | | | |  _| |_  | |  _|___|
| |   |_|   |  ___| |  ___  |  ___|_| |_|_________|  ___|___    | |_  |_  |_|___| |  _| |_|  ___|_____| | |   |  _| |___|_  | |_____|___    |
| | |_  |_| |  ___| | |   |_|_____  | |  ___  |   | |    _____| |  _|_  |_______  | |   |  _|  _  |  ___| |_|___  |_  |  ___| |  _  |   |_| |
| | |  _|  _| |  ___| | |_  |   |  _| | | |   | |___|_| |  _  | | |  ___|  _  |  _| | |_| |   |_____|  ___|  _  |_|  _|_  | | |_  |___| |   |
| | |_  |   | | |_____| | | | | | |   |_  | |_|_________| | | | | |_  | |_  |___| | |_  |  _|_|  _  |___  |_  |_____|   | |  _|  _|_______| |
|  _| | |_|  _|___  |  _| |___|___| |  _| |___________  |_  |_______| |_________  |_  |_  |   | | | |  ___|  _____  | |_| | |___   _____  |_|
| |_  |_  |___   _| | |   |  ___|  _| |  _|_   ___    |_____|  _____  |  _  |  ___| |_  |_| |___|  _|_______|  _  | |_  | | |   |_|  _  |_  |
|___   _|_  |___|   |___| | |  ___  | | |   |_____| |_____  | |  _  | |_  | |___  |   | |  _|_  |___  |  _  | | | |___  | |___|_  |_  |___  |
|   | |  ___|   | | |  _| |  _|   |_| |___|_____  | |_  |  _|___| | |___| | |_   _| | | | |  _  |  _|___| | | |_  |_____| |_    | |  _|_____|
| |___|_  |  _|___|_  |  _|_|  _| |  _____  |_  |___|   |_  |  _  |_______|_  |_____|_| | |   |___|  _  |  _|_  |_____  |_  | |___|  _____  |
| |   |  _| |  ___  | |___   _|_____|_   _|_______  | | | | |___|  _  |___  |___________| | | |   | |  _|_______|    _|_____|_  | | |  _  | |
| | |___|  ___|   | |_|   | |  _____  |  _   _____|___|_  | |   |_  |___  |_   ___  |_   _| |___|___| |  _________| |  _  |   | |  _|_  |_| |
| | |   | |___  | |_  | |___|_  |_  | |_  | |  _______  | |___|_____|  _|_  |_  | | |  _| | |   | |  _| |_     ___|___| |___|___|___  |_  | |
| | | | |_  |  _|_  |___|_  |  _|   | |  _|___  |  _  | | |  ___    |    _|_____| |___| |  _| |_  | |  _|  _|_|   |    _____  |    _|_  | | |
|_| | |_  |___|  _|___  |  _| |_  | | | |   | | |_  | | | |_  | | |_| |_    | |  _____  |_  | |___| | |  _______|___| | |  ___|_|___   ___| |
|  _| |  _|  ___  |  ___| |  _|  _|_| | | | |  _| | |___| | |_  |_____|  _| |___|  _  |  _| |  _  | | |___  | |  _____| |_  |    _  | |   | |
|  ___| |_   ___| | |  ___|_   _|  ___|_| | |___  |___  | |   |_____  | |_________|  _|_  | | | | |___|  _____|   |_    |  _|_|_  | | | |_  |
|  ___|   | |  ___|_  |   |  _|  _|  _  | | |_________|_  | |_  |  ___|___  | |   | |     | |_  |_  |  _|  _  |_|_  | |_|_________| |_|_  | |
| |   |_| | |_  |  ___| | | | |_____| |___|_  |  _____  |___| | |_  |  _____|  _|_  |_| |_| |_   _|_____| |_  |  ___| |  _   ___  |_  |  _| |
| | |_   _|___|_____|  _|___|  _   _________| | |     | |   | | |  _|_  |_____|   |_  |_  |_  |_|  ___  |   |___|_______|  _| |  ___| |_  | |
| |_  | |  ___  |  ___|   |_____| |  _____  | | |_| | |___| |___| |   |_____  | | | |___  | |_____|  _| |_|___  |  _  |  _|  _|  _|  _|  _|_|
| |  _| | |    _| |  ___|_______  |___  | | | |___  |_|  ___|  ___| | |  _|   | | |___  | |  ___  |   |_________|   |___| |  ___|  _|  ___  |
| | |___| | |_|  _| |_     _|   | |_  | |_   ___|  _|  _|  _________|___|  _| | |___  | |___|   | | |  ___  |  _| |_  |   |___  | |  _____| |
| |_  |  _| |  _|___  | |_____| |___  |_  |_|   | |  _|  _|  ___  |  _  |_  | | | |  _|    ___|_| |_| | |  ___|  _|  _| |_______| | |  ___  |
| | | |_  |___|  _  | |_  |  _|_   _|_  |_____| | | |  _| |___  |___|_______| | | |_  |_|_   _________| | |  ___|  _|  _|  ___  | |_|_  |  _|
| | |_  |_  |  _| | | | | |___  |___  | |_    | | |___|   |_  |___  |   |  _| |___  |___  |_|   |_____   _|___  | |_   _|_  | | | |  ___| | |
|_  | |_____| |   | | | |_________  | |_  |_| | | |  ___|_  |___  | | | |_____|   |_  |  _|  _|_____  |_|   |  _|_  |_|   | | |___| | |  _| |
|_____________|_|_____|_____________|_________|_____|_____________|___|_________|_____|_____________|_____|_______|_____|___________|_______|
