_____________________________________________________________________________________________________________________________________________
| |  ___    |  _   _____  |   |  ___   ___|  ___   ___|   |  _   ___|  _   _  | |  ___    |_   _  |___  |  ___________    |  _    |   |    _|
| |  _|  _| |_  |_  |  _| | | |___  |_______|  ___|_____| | | |_________|_  | | |_  | | |_____| | |  ___| |  ___________| | |  _| | |___|_  |
| | |  _| |  _|_  | |_   _| |_______|_   ___|___   ___|  _|_____  | |  _  | | |_______| |   |  ___|_______| |   |  _______|_|_  | |_|  _  | |
|  _| |_____|  ___|_  |_|  _|  ___  |  _|  _   _|_______|_____  |_  |_  |___|___________| |_| |     |  _  | | | |_  |  _________| |  _|  _| |
|___| |  _____|___  |_  | |  _|  _| |_  | | |_   _______________  | | |_  |___    |  _____  | |_| | | | | | | |_|  _| | |    ___| | |_   ___|
|  ___| |_  |     |   | | | | |   |_  | | |_  |_____  | |    ___| | |   |___  | |_____  |  _|_____|___| |___|_  |_____| | | |  ___|_  |_|   |
| |   |_  |___| |___| |___| |  _|  _| |___  |_    | | |  _| |   | | | | | |  _|_|   |___|    _  |  ___   _____  |___   ___| | |___   _|  _| |
| | |   |_  |  _|  ___|  _  |_  |_  | |   |_____|  _| |_  |___|___| | |_  | |  ___|___  | |_  | |_|  ___| |  ___|   |_|  _  |___  |  _____| |
|  _| |___| | |_____|  ___| |_  |   | | |_  |_  | |  _|_   _|  _____| |_  |_____|  _____|  _| |_   _|_________   _|_  |   | |  ___|_  |   | |
|_  |_  |  _|_____   _|   |_  | | |_|___| |_  |  _|___  | |  _|_   ___  |___  |  _|   |___|  _|  _|  _  |   |___|   | |_| |_|_  |_   _| |_  |
|  _| | |_______  |_|  _|_____| |___  |  _____|_  |   | | | |   |_____| |  _| | |  _| |   | |___  | | | | |_______| |_  |_   _|_  |  _|_  |_|
|  ___|  _  |   |_____|  _______|   | |_  |_    | | |_  |_| | | |  _   _|___  | | |_  | | | |   | | | |___| |  _  |_  |_____|  ___| |   |_  |
| |  ___|  _| |  _   _| |  _______| |_  |_  |_|_  | |___|  _| |___|  _|  _  |_| |   |___| |___| |_| |_  |  ___|   | | |   |  _| |  _| |___  |
|_| |  ___|___|_  | |  _| |_   _  |___  | | |   | |_______|   |_______| |  _____|_|   |_____  |   |_  |___|   | |  _| | |___| |  _|  _|  ___|
|  _|___________  |_| | |_  |_  |_______| |___| | |   |___  |_|  _  |  _| | |  _  |_|_  |_   _|_|_  |___  | |___| |  _| |  _|  _| |_  |___  |
|  _  |_  |    _| |  _|   |_  | |_   _  |  _  | | | |___  |_  | |   | |_   _|_  |___  |_  | |  _  | |  ___| | |  _|_  | | |  _______|___  | |
|  _|_  |  _|_  | | |_  | | | | |  _|  _| |___| |  _|_____  |___| |_|_  | |   | |_  |_  | |___|_   _| |  ___| | |  _|___|_   _|  _____  | | |
|_|  _  |___|  _| |_____| | | |___| |_  |  _  | |_|  ___  |___  |___  | |_| |___|  _|  _|  ___  |_|  _| |___   _| |    _  |_|  _| |  ___| |_|
|  _|  _|   |_______  |  _| |___  |   | |_|   | |  _| |  _| |  _|   | |_____|_____  |_  | |   |_____|_____  |_  |___| | |_  | |  ___|  _|   |
| |___  | |_____  |___| |   |   | |_| |_____| |___|  ___| |  _|_  |___   _________  | | |___| |  _  |  _____| |_______|_  |___|_  |_______| |
|___  | | |    _| |   | | | |_| |_  |_   ___|___  |_  |_  | |_    |   |_|  _  |  _|_  |_  |  _|_  |___|  _  |  ___   _  |___    |_______  | |
|   | | | | |_  |___| | | |_______|_  |  _____  |  _|_  |_______|_| |_  | |  _|___   _| | |_______|   | |  _|_  | | |___  |  _|_|  _______| |
| |___|_| |___| |   |___|___  |  _____|  _|   |___|   |_  |   |   | | |___| |_    |___  | |  _|    _|___|___|  _| |_  |_____|  ___|_    |   |
|   |   | |   |___|_   _   _  | |     | |  _| |  ___|_____| |___|___|_    | |  _|___  |_| |_   _| |  _  |  ___| |   |_  |  ___|  _____|___| |
| | | |___| |_  |   | |  _|  _| |_| |_| |_  |___|      _____|    _  |  _|_|___| |   |_  |   |___|  _| | | |_____  |_  |___|  _  |_  |  _  | |
|_| | |  ___  |___| | | |  _| |_  |  _____|_  |___| |_|   |  _| |_____|  _   _|  _|_____| | |   |___  | |_____  | | |___   _| |_  |  ___|___|
|   | |_  | |_  |  _| | |  _____| | |  _______|   |_  | | |_  | |  _____|   |  _|     |___|___|_  |  _|_________|  _|   |_  | |  _|_  |  _  |
| | | |_____  | |_  |_| | |  _  | |_|___  |  ___|_  |___| | | |___|   |   |_| | | | |_________  | | |  _____|   | |  _|_  |  _| |   | |_  | |
| |_|_  |  ___|_  |  ___|_| | | |___  |  _|___  |_________| |_  |___| | |_|  _|___| |  _____  |___| |___   ___| | | |   | | |   | | | |  _| |
| |  ___| |  _____| |  _____| |___   _|_  |   |_   ___    |  _|___  | | |  _|  _____|_______|     |___  |_   _|___| | |___| | |_| | |_| |   |
|  _|_____| |___   _|_  | |   |   | |  ___| |_  |_|   |_| | |    _| | |___|  _|  _________  | | |_  |  _|___|   |  _|_  | | |_  | | |  _| |_|
| |_   _  | |   | |   | | | |___| | |___  | |_______| |  _|___|___  |_   ___|  _|  ___  | | |_|_  |_|_________| |_  | | |___  |___|  _| |_  |
|_____|  _|  _| | | |___|_____  | | |_  | |___  |   | |_   _____  |_____| |   |_  |  _| | |___  |     |_   _  |_____| |___  | |   |_  |  _| |
|  _____|  _|  _| |_____  | |  _|___|  _| |  ___| |_|_  | | |  ___|   | |  _|_  | |_______|  ___| | |_  |_  |  ___________| | | | |_____|   |
|___  |___  | |___|    ___|_____  |   |  _| |_   _______| | |_  |  _| | |_  |  _| |   |  ___|_____| | |_  | | |  ___________|_| |_  |   | | |
|_  |_  |___| |   | |_|  _  |_______| |_  |   |_  |  _____|  _| | |_  | |  _|_  | | | | |_   _______| |  ___| | |  _  |  ___  |_  |___|___| |
|  ___| |   | | |_  |  _|   |   |   |___| | | |_  |_   _____|  _|   | | |_  |  _|___|___  | |_   _|  ___|   |_| |   | |___  |_  |___  |  _| |
| |   |  _|___| | | | |  _|_| |___|_______| |_  |_  |_|   |  _|  _| |___|  _|_________  |___|  _|  _| |  _|_  | |_| |_______| |___  | | |  _|
| | | | |  _____|___| |_  |  _|   |___    |___|_  | |  _|___| |_  | |   | |_    |___  |___  |_________|___  |___|  _| |  ___________| |  _| |
|___|___|_______________|_______|_______|_________|___|___________|___|_______|___________|_______________________|___________________|_____|
