_____________________________________________________________________________________________________________________________________________
|   |  _   ___________  |    _|  ___   ___  |_  |  _   _____  |  _   _|    _____  |  ___   ___   ___  |  ___|    _  |___   ___  |  _  |    _|
| |___| |_____  |___   _| |_  |_  |  _|  _| |  _| | |_  |  ___|_  | |  _|___  | | |_|   | | |  _|  ___|_______|_  |___  |   |  ___| | |_|_  |
| |_    |  _  |___  | |  _| |_  | | |   |  _|_  | |   | |_________|_|_____  | |___  | | |___|_  | |___   _____  |   | | | | |_|   | |_____  |
|_____| |   |___  | |_|_____  |___| |_|_________|___| |_____  |  _   _|  ___| |   |___|___  |  _| |   |_    | | |_| | | |_|_____| |  _|  ___|
| |  ___| | |   | |_     ___|_   _|_______  |  _  |  _|   | |___| |_______|   | |_  | |  ___| |  _| |_  |_| | | |  _| |___________|  ___|_  |
| |_  |___|___| | | | |_|    _| |  _____  |  ___|  _____|___  |   |   |  ___|_|_  | | | |   | | |_    |_  | | | | |   |_     _|   |_____  | |
| |  _|  _______|_  |_____|_  | |_  |  _| |_|   |_|   |_________| | | |_  |  _____| | |___|___|_  |_|   |___| |___| |_  | | |  _|_____  | | |
|  _|_____  |  _  | |___   _|___| | |   | |  _|_____|_  |   |_______|_  |___|_  |  _|  _|   |   |_  | |_  | |  ___  |  _| |_|___  |   | | | |
|_______  |  ___| |_______|  ___  | |_|_____|    _____|___| |  ___  | |_______  |_  |  ___|___| |  _|_|  _|___|  ___|_  | |  _  | | |___| | |
| |  _____| |  ___|  _  |  _|  _| | |  ___  |_|   |  _    |___|  ___| |  _______| | |_  |    _|_____  | |   |  _| |  _____|_  | | |_______| |
|  _|_    | | |  ___|   | |   |  _|_______|   |_|___|  _| |   | |    _|_  |___   _| |_____| |   |   |_  | | | |_   _|  _|  ___| | | |  ___  |
|_  |  _| |_| | | |  _|_|  _|_|_  |  ___  | |___  |  _|_  | |___| |___  |___  |   |_____  |_| |___|_  |_| | |   | |  _  | |_  | | |___|   | |
| |___| |_  | |_  |___  | |  ___  | | |  _|_|  ___| |   |_| |   | |_  |_    | | |  _____| |  _|  ___|_____| |_| | |_|   |_  | | | |   | | | |
| |  _  |  _|  ___|   |___| |___  | |_   _____| |  ___|_  | |_|_________| |_| |_| |  _____| |_  |  _____  |_  | |_____| | | | | | | |___| | |
|_____| |_  | |    _|___  |___  | |_  |_|   | |  ___|   | | |  ___  |   | |  _|   |_____  |_  | | |  _____|  _| |___   _| | | |___| |   |_  |
|  _  |   | |___| |   |  ___  | |___|_  | | |_____|  _| |  _|___  |___| | | |  _|___|   | |  _| | |___  |_  |   |   |_____| |  _____| |_  | |
|   | |_| | |_____| | |_|   |_|_____  |___|_  |  ___| | |_________|   | |  ___|  _____| |_______| |  _|_____| | | |___  |  _| |    ___| | | |
| | |___  |_____  | |_  | |_______  |  _  |  _|_  |   |_  |    _____|_| |  _|  _|_   _____________| |  ___  | |_______| | |  _| | |___   _| |
| |_  | | |  _  |___| |___|  _______|_|   |___  |_  |_|  _| |___________|_|   |   |_|   |___   _   _| |   |_   _|  _  | | | |  _|___  |_|  _|
| |  _|  _| |___|  _____  | |    _______| |  _|_____|  _| |_______  |    ___|_| |_  | | |   |___|_____| |_  |_|  _| | | |___| |_    |_____| |
| |_  | |   |  ___|_  |  _| | | |   |  ___|_____  |  _|___   ___|  _| |___  |  _| |___|___|_  |  _  |  _| |_  |_  | | |_   _|_  | | |_   _  |
|  _| | |_| |_____  | |_  | |_| | | |_  |_   _____| |_    | |  ___|  ___|  _|  ___|  _   ___  |_  | | |_    | |  _|  _|   |   |___|_____|  _|
| |  _|_______  | | |   |___|  _|_|  _|_  | |  _  |_  | |_  |_  |___  |  _|  _|  _  |___|   |_|  _| |_  |_| |___| | |  _| | |   |  ___  |_  |
| | |   |___  |_  | | | |_   _|_    |   | | | |_______|_  | | |___  | |_______|_  | |  ___|_______|   |_  |_    |  ___|___| | |_|_  | |_  | |
| |___|_  |  _|  _|___|_____|  ___|_| |___| | |   |_   _  |_______| | |_    |  ___|_|_  |_  |  _  |_|   |   |_|_  | |  _____|_______|_  | | |
| |  _____|___  |  _  |  _______  |  _|___  |___| |  _|_  |  _______|_____|_|_______   _____|_  |_  | | |_|  _  |___|_________  |  _____|___|
|_|_   _____  | |_  |_| |  _|  _  |_____  |_    | |___  |_| |    _|    _______  |   | |  _______|  _|_|_  |___| |  _   ___|   | |_________  |
|   |___|  ___|_  |_______|  _|  _____|  _|  _| | |   |  ___|_|_   _|___  |   |___| | |___  |  _| |_   ___|  _  |  _|___  | | |_________  | |
| |___  | |  ___| |  ___   _|___|  _  | |   | | |___| | |  ___  |_|   |  _| |_____| | |  _| |   |_____|  _  |___| |  ___  | |_   _____  |_  |
| |   |___|  _____| |_____|  _  |  _| | |_| |_  |  ___| |_  | |_____| | |  _  |   | |_  |  _| | |  _   _| | |  ___| |   | |_  |_  |   | |  _|
|___|_  |___________|   |  _| |___|   |_  |_  | |___  | |  _|   |  ___| | | | | |___|___| |___|_  |  _| |  _|_  | |___| |_|  _| |___| | |_  |
|  _  |  ___  |  _____| | |  _|  ___|___| |  _| |  _| |___|  _| | |_   _|___| |_  |     |_____  | |_  |  _|   | |  _  |_____|   | |  _|___| |
| |_  |  ___| |_  |   |_____|  _|  ___  |___| |  _|  _|_   _|___|_  | |  _  | |  _|_| |___  |  _| |  _| |___| | |_  | | |    _| | |_________|
|   | |_|   |  _| | |___  |  _|  _|  _|___   ___|  _|    _|  ___  |___|   |___| |  ___|   | |   |_| | |___  | |_____| |___| |  _|   |_   ___|
| | |_____|_  |  _| |  ___|  _____  |  _  |___|  _|  _| |  _|_  | |  ___|_  |  _| |___  |___|_|_  | |   |  _________|_  |  _|_____|_  |___  |
| |___  |   |_|_  | | |   | |  _  |_|_  |_______|  _| | |_____  |___|  _  |___|_  |   | |  ___  | | |_|___|  ___  |  ___| |  ___|   |___  | |
|___  |___|_______| | |_| | | | |_______|  _|  _  | |  _______|_______|  _|_    |  _| |___|   |___|  _______|  _| |_______| |  ___|___  |_  |
|  _|_|  ___________|_  |  _| |  _|   |  _  |_  | |___  |  _______   _|_  |  _| |___|_  |  _|   |  _|  _  |___  |_______  |  _|  ___  |   | |
|___  | |    _|  _  |  _|_|  _|   | | |_  |_____|___  |_|___  |   | |   |___| | |  _  | |_  | |_|_  |_  | |   |   |_    | |_  |_  | | | |_| |
|_______|_|_______|_________|___|___|_______________|___________|_|___|___________|_____|___|___________|___|___|_____|_|_________|___|_____|
