_____________________________________________________________________________________________________________________________________________
|  _______   _|  _____    |_____   _   _________  |    _|    ___  |   |_____  |  _   _  |     |_______   _   ___  |_  |  _   ___|     |   | |
|___   _|   |  _|   |  _| |  _  |_|  _| |   |  ___| |_|  _| | |  ___|_________|_  | |___| | | |  ___  |_|  _|  _|_   _| | |_______| |___|___|
|  ___|  _| |_  | |_|_  |___| | |  _|   | | | |    _|  _|  _|  _|  _________  |  _|_______| |___|  _|_____| |  _____|  _|_   _  |  _|  ___  |
| |   |_  | | | |_    |_  |_  | | |___|___|_____| |  _|   |___|  _| |  ___   _| | |    _|  _| |   |  _________|  ___|_______|  _|_____|  _  |
| | |_____|___|_  | |  _| |  _| |  _______  |   | | |  _|_|  ___|   |_  |  _|  _|_  | |  _|   | | |_  |  _   ___|  ___________|   |_  |_  | |
| |_______________| |_|  _|  ___|_________| |_|_  | |___  |___  | |_  | |___|___  | | | | | |___|  _____|  _|  ___|___   _|    _|___  |  _|_|
| |  ___  |___    |_  |_  |_  |    _____   _|   | | |   |_______| |___| |  _______|_| | | | |   |_|  _  |___| |___    |_  | |_  |  ___|___  |
|___|_  |_  |  _|_  | |  _|_____|_|   | | |  _| |_| | |___  | |  ___  | |_____  |_    | |___| | |  ___| |  ___|   | |_  |___  | | |  _  |   |
|  _  |_  |___|  _| | |_________  | | |___|_  |_____| |  _| |___  |  _|___   _|___  |_|_______| |_  |  _| |  _  | |_  | |   |_| | | |   | |_|
| |_________  |   | |  ___  |   |___| |  _____|   |_  |  ___|   | |___    |_________|  _____  |  _| |_  | | |  _|_____|___|_  | | |_| |_|_  |
| |  _____  | |_| | | |   |___| | |  _|_  |_   _|_____|_______| |___  | | |   |   |   |___  |_  |  _| |___|_| |  _  |___  |  _| |_  | |   | |
| | |    _| |___  |___| |___  |_  |_______|  _|   |   |   |   | | |  _| |___|___|_| |_|   |___  |_________  |  ___| |  _  | |  _|  _| | |___|
|  _| | |  _|  ___|___  |_______| |    _  | |  _| | |___| | |___|_   _|_  |  _______|  _|___  |_____   ___| |_|  ___|_  | | |_  |___  |___  |
| |___| | |_  |  ___  | |   |  ___| | | |___|   |_| |  _|___|     |_|  _  |___  |  _____|   |_____  | |  ___|  _|  _   _|_|_____|   |_  |  _|
|_   ___|_  | | |   | | | |___|_   _| |___  | |_____|    _  |_| |_  | |  _|  _| |_  | |  _|_  |  ___| | |_   _  |_  |___   _  |  _| |  _|_  |
|  _|    ___|___|_|  ___|_  |   |_|  _|   | | |   |___|_  | |  _|  _| |___  |    _| | | |   |___| |  _|_  | | | |_____  |_  |___|___|_  |   |
| | | | |   |  _  |_|    _|___|___  |  _| | |___| |   |  _| | | |_  | |___  | |_|  _| |___|_  |_  |_  | | |___| |  _  | |  _|   |   |  _| | |
|_  | |_| | | |  _|  _|_____   _|  _| | | |_________| |_  |___|_  | |___  | | |  _|_______  |_  |_   _| |___  |  _| | | | |  _|___|___| | | |
|  _|_____|___|_____|   | |  _|  ___| | |___  |   |_______|  _   _|_______| | |_  |  _____  | |_  |___  |   | |_____| |_| | | |  ___   _| | |
| |___   _____________| | |_____| |  _|  _|  _| |_____  |_   _|_____   _____|  _|  _|  _  |_   _|_  |___| | | |  _____|  _| | |___  | |  _|_|
| |   | |   |  ___  |  _|___   ___|_  |  ___|  _|  _  |_  | |  ___  |_  |   | |  _|  _| |_  | |  ___|   | | | |_  |  _______|    _| | |___  |
|___|___| |___|   | |_  |   | |  _|  _|_______|   |___  | |_|_  |  _| | | |_|___| | |_  |  _|_| |  ___|___| | |  _|_  |  _  | |_|  _| |  ___|
|  _|   |  ___| | |_  |___| | | |_   _  |  _  |_|_  | | |_______| |   | |    _|   | |  _| |  _  |___  |   | |_  |   |___|  _|_   ___| |___  |
|   | | | |  ___|_______  |_  |_  | | |___  |___  | |_  |___    | | | | | |_____| | |_______| |_  |  _| | |_____| | |   |___  |_|   |  _|   |
| | | |___|___  |___    |  _|_  | |  _|   | |   | |   |_______| | | |_| |_|  _  | |_____  |  _|  _| |_  |_____  | |___|_  | |_____| |_  | | |
| |___|___    |___  | |_| |  ___| |_|  _| |_| |___| |_  |  ___  | |_  |_  | |  _____|   | |  _____|_  |   |_____|___  |  _|___    |  ___| | |
|_  |  _  | | |  _| |_____|_   _| |  _| |_  |_  | | |  _|_|   |_|_  |  ___  |_|  _____| | |_|  _______| | |  _  |  ___|___  |  _| | |  ___| |
| |___| | | |_  |  _|   |   | |  _|_  |  _|_____| | | |  ___|_    | |_|   |_|  _|  ___| |  ___|_   _  |_|___  | |___  |   | |   |_| |_  | | |
|    _|  _| |___|_____|___| | |_______|_______  |  _| |___   _| | | |  _| |  _|  ___  | | |  _  |_  |_  |   | |_  |  _| |___| | |  ___| | | |
| |_____| |  ___    |_    | | |    _|    ___  |___|  _  | | |   |_| | |___  |_______|_  |___|_______| | | | |_|  _| |  _|_  | | | |   | | | |
|___  |  _______| |_____| |___| | |  _|_  | | |   |_  | | | | |_|  _|___  | |  _  |   |_  |   |  _  | |___|_   _|  _|_  |  _| |___| |___| | |
|  _| | |  _______|  _____  |  _|___| |   |_____|_____| | | |_____|_    | |_|_  |___|_  | | |___|  _| |  _  | |  _|_  | |   | |_  | |___   _|
|  ___|_|   |   |  _|  _  |_| |  _____| |_|  _  |___   ___| |  _______| |   |  _| |  ___|___|  _|_  |_   _|___|   |  _| | |_______|___  | | |
|_____  | | |_| |_  |_  |_____|   |   |_  |_  | |   |_|   | |___  |  ___| | | |   | |  _   _|     |_  |_|  _  | | |_   _|_  |  _____  | |___|
|  _  | |_|_  |_  | | |_____  |_|_  |   |_____|___|_____| |_______| |  ___|___| |_| |___| |  _| |_  |_  | | | |_|_  | | |  _| |_  |  _|  _  |
|_  |___|   |_  |  _|_____  |___  |_| | |___    |_      | |    ___| |_____  |   |  _|  ___|_  |_  |_|  _| |_________| | |_  |_  |_  |_  |   |
| | |    _| |  _|_________  |  _|_____|_______|_  |_| |_| | |_______| |   |_  |_| | |  _______| |_  | |   |   |_   _| |  ___| |_  |_  |_| | |
| | |_| | |___|  _|  _  |  _|___    |_____    |  _|   |  _|___  |   |___|___  |  _|  _|_    |_    |___| |___|_  | |  _|_____   _|_  |_  | | |
| |_____|  _|  _____| | |_____  | |_____  | | |_____| |_________| | |  ___  |_|_  | |_   _|_____|_  |_____|  ___|  _|   |_____|   |_  |___| |
|_____________________|___________|_________|_______|_____________|___|___________|_____|___________________|_________|_________|_____|_____|
