_____________________________________________________________________________________________________________________________________________
|  _  |  _    | |  _    |___  |  _  |  _____________________   _____  |  _  |    ___|  _____   ___  |___   _|  _______      |___     _____  |
|   |_| | | |___| |   |_______| | | |_  |_  |    ___|  ___  |_   ___| | |  _|_|_____  |  _____|___  |  ___|  _|   |   |_| |___  |_|___  |  _|
|_|_  | | | |  ___| | |  _  |  ___|  _|_  |  _| |   |_  | |_  | |  ___| |  _______  |_| |   |  _  | |_   _____| |___| |  _|  _|___  |  _| | |
|   | |_  |___|_  | |_|_  |___|   |___  | |___|  _|_  | | |  _|_| |___  |_|  ___  |_  |___|_____| |_  | |  _____|   |___| |  _______| |  _| |
| |  ___|_____  | |_______| |  _|_______|___  |___|   | | |_______|  ___|  _|_  |_  |_  |  _______| | |_| |_  |   |_|  _____|___   _  |___  |
| |_|  _____  |_______  |   |___________   _|  _____|_| |  _|    _|  _  |_______  | |  ___|  ___  | |_  |   | | |_  | |  _____  |_  |_  |  _|
|_  |_  |_  |_  |    _| | |___  |   |   |_  | |  _  |  _|_____| |  ___|_______  | | |_|  ___|_  | |  _| |_| |  _| | |___|  _____  | |  _|_  |
|  _  |___  | |___|_____|_  |  _| |_| |_  |___| |_____|  _  |   | | |   |  _  |  _|_   _|  _   _| |_________|_____|_______|   |_  |_|___  | |
|   |_|   |_____  |_    |  _| |___  | | | |    _|   |  _|  _| |_|_  | | | |  _|_|   |_____| | |  _|  _____  |  _____________|_  |_____  | |_|
| |_  | |  _____|_____|___| |___  | |_  | | |_|  _|___| | |_   ___  | | | |_______| |   |  ___| |  _|   |   |_____  |   |_    | |_    | |   |
|_  |___|_  |  _______________  | | |  _| |_  |_  |    _|_  | |   |_| |___|  _  |  _|_| |_  | | |_  | | | | |  _|  _| |_____| |_  |_| | | | |
|  _|_  |   | |   |  ___  |  _  | |___|  ___|  _| | |___  | | | |_____|    _|  _| |  _____| | |_____| | | | | |  _|___  | |  _|  _|  _| |_| |
|_____  | |_| | |___| |  _| |___|___  |  _  |_____|___  | | | | |  _  | |_  |_  | |_   _  | |  _______| | |___|_  |   | | |  _| |_  |  _|   |
|  _____|_____| | |   |_  |___  |  ___|___|  ___  | |  _| | |_|___|  _|  _| |  _|_  |_  |_____|  _  |___|_____   ___|___|___|  _|  _|_  | | |
|___  |  _|  ___|_  |_  |_____  | |   |  ___|  ___|___|  _| |  _____|  _|  _|_  | |_  | |  _____| |___  |  _  |_|  _  |  _____|   |  ___| |_|
|  ___|_  |_____  | | |_________| | |___|   |_________  |  _| | |   | | | |_  | |_  | |_|_  |  _  |_  |_____| |  _|_  | |   | | |___|_   _  |
|_____  |  _  | | | |_  |  _______| |    _| | |  ___  | |_____|___|_  | | |  _|_  | |_______| |  _|  ___|   | |_____| |_  | |_______  |___| |
|  _  | |_  |_  | |___  | |   |_    |_| | | |_____|   | |_   _____  |_  | |_____  |  ___  |  _| |  _  |  _|_________|_  |_|_   ___  |_____  |
| |___|_____| | |_  |___|___|_  |_|_  | |  _|   |  _|_|_____|   |  _|___|_   _  | | |  _|___| | |___| |_  |  ___  |   |___  |_  | | |  _____|
|_  |  _____  |_  |___  |    _|_  |  _| |_____|___|  ___  |   |_|_______  |_|  _| | |_____    |___  |_  | |_  | |___|  _|  _|  _| | |___  | |
|  _| |    _|  _|_  | | | | |   |___|  _____________| |  _| | |    ___  | |  _| |___|  _____| |  ___|   |_  | |   |  _|  _|_______| |_  | | |
| |  _| | |   |  _____|_  |___| |  ___|_   ___    |_  |_____|___|_  |_  | |_  |  _  |  _  |___|_  |  _|___| | |_| | |  _|_    |  ___|  _|_  |
|  _|  _| | | | | |  _  | | |  _|_____  |_|  ___| |   |  ___  |   |_  |_|_____|_  |___|  _|   |  _| |   |   |_  | |___|  ___| |_  |   |  ___|
| |  _| | | |_| | |_  | |___|_____   _|_  |___  | | |___|  ___|_|   |_  |   |   |_  | |_  | | |  ___| |___|  _| |  _   _|  _______| | |_  | |
| | |___  | |  _____| |_______  |   |  ___|  ___|___| |  _|  _  |_| |  _| | | | |  _|_  |___|___|  ___| |  _|  _|___| | | |  _  |  _|_____| |
| |___  | | | | |  _  |  _  | |_  |_|_  |___  |  _______|   |___  | |_____| | |___|  _____|     | | |  _____| |    ___|___|_  | |_  |_      |
| |   | |_| | | |_  | | |  _|_   _|   |_______|_  |   | | |_  | |___  |  _| | |_____________| |_| |_____|  ___| |_|  ___  |  _|_  |_  | | | |
|___|_  |  _| |_  | |_| |___  |_|  _|  _  |_    |___| |___|  _|   |  _| |  _|___  |  _  |   | |  _|  _____|  _____  |   | |_  |  _| | |_| | |
|  _  | | |  _|   |_  | |  _| |  _| |_  |_   _|___|  _|  ___| | | | |  _| |  _  |___| |___| | | |  _|  _  | | |   |___| |_____| |_________| |
| |  _|_|_______|___| | |_  |___|  _  | |  _|  _____|_  |  _|  _|___| |  _|_  |_____   _|  _| | |_  | |___| | | | |_____   ___|___  | |  ___|
| |_____  |   |  _____|_  |___  | |   | | | |___________|  ___|___    |___  | |    _|_  | |_  |_____|_________| |___  |___|  ___  | |  _|  _|
|  _  |  _| | | |  _______|  ___| | | | | |  _    |___  | |    _   _|_|  _  | | | |  _  |___  |   |  _  |   |  _|   |___  | |   |___| |  _  |
|_|  _|_  | | | | |_   _  |___  | | |_| | |___| |___  | | | | |___|   | |___| | | |_  |_  | |___| |_  | | | |_  | |___  |___| | |   | |___| |
|  _|  _____|_  |_  |   |___  | | |_  | |_   ___|   | | | | | |  ___| | |   | | |_  |_  |_____  |_____| | | |  _|_____|_    |_| | |___|  _  |
|   | |  ___  |  _| |_| |  _| |_  |  _| |___|   | |_|_  | |_|___  | | |___| | | |  _| | |  _  |_______|___|___|  _   _____| |   | |___  |  _|
|_| |_|_  |  _| |  _|  _|_  |_  |_|   |_______| |_____  |___  |  ___|   | | |___|_  | |___| |_________   _______|  _|  _  |___| | |  ___| | |
|  _|  ___|_  |_| |_  |   |_  |_  |_|  _  |_  | |  _  |_  | | |_  |  _| | |___   _| |_   _  |  _  |  _| |  ___  |_  |_  | |_   _| |  _  | | |
|   |_____  |_  |_____| |_____  | |  _| |_  | | |_  |_  |  _| |___| | | |___  |_  |_____| | | | | |   |___|_  | |  ___| |_  |_  | |___| |_  |
| |  ___|  _| |_   _|   |  _  |_| | |  _|  _| |_____| | |_|  _|   | | |___  |   | |  _   _|___|  _|_|  ___  | | |_|   |_  |_  |_| |   |_  | |
|_|_____________|_____|_____|_______|_________________|_________|___|_________|_|_____|_______________|_______|_____|_______|_______|_____|_|
