_____________________________________________________________________________________________________________________________________________
|   |   | |   |     |  ___________|  _   _|   |  _____   ___  |  _____    |  _  |  _________  |  ___  |  _____   _________________  |_     _|
| |___|___| | | | |  _|  ___  |   |  _|_  | |___|  _____|   | |___|  ___| | |  _| |  _____  | |___  |___|_    | |  _________  |   |_  | |_  |
| |  _______|_  | |_|  _|  _  | |___|  ___|_  |  _|  _____| | |   |   |___| | |  ___|_  |  _|___  | |  _    |_| | |     |_  |___|_  | |_|   |
| |_   ___|   |_|_____|  _|  _| |   | |  _____|_  |___  |  _| | | |_|___   _|_____|   |  _|  _|   | |___| |_|   | |_| |_  |___   _| |_____|_|
| |  _|  ___|_______  | | | | |___| |___|  _____|  _|  _| |_____|_____  |_|  _______| |_  | |  _|_|_   ___|  _| |_  | | | |   |_  | |  ___  |
|_____| |  ___  |  _____|  _| |  ___|   |  ___  |_____| | |  _  |  ___| |  _|_    | | |_____|___    | |  ___|  ___|___| |___|  ___|_  |  _| |
|  _  | |___|   | | |   |_  | | |  ___|_| | |  _|  _    |___| | |_________|  _  |___|_________  | | | |_  |  _|  _______   _| |  _  |___|  _|
| |_  |  _  | |_| | | | | |_  | |_____   ___|_____|  _| |   | | |  _  |  _  |___|  _   _  |   | | | | |  _|_  |___   ___|_  | | | |___  |   |
|   | |_|  _|_  |  _| | | |  _| |  _  |___|  _______| |___|  _|_   _| |_  |_______| | | | |_| | | |___| |_   _|  ___|  _  |  _| |  _____|_| |
|_| | |   |   |___|  _| |___  | |_  | |  ___|  _____   ___| |   |_|  _| | |   |_    | |  _|   | |___  |_  |  _|_  | | | | | | | | | |  _    |
|  _|___|_| | |  _____|_  | | |_  | |___|    _| |  ___|  ___| |_____|  ___| | |  _| | |_____| | |_   _|  _| |  _____| | | | | | | |  ___| | |
|  _________| | | |  _____|  _|  _| |_____| |  _| |   |_  |  _| |  _________|___|_  |_____  | |_  |___| |___|_  | |  _| | |___| | |_|  ___| |
|_  | |  _  | |_  | |  _  |  _| |  _|  _  | |_____| |_  | |_  | | |  _____  |  _  | |  _____| | |___  |  ___  | | |_  |_   _____|_____| |  _|
|  _| |_  | | |  _| |_  | | |  _| |  ___| | |  _  |_  | |_  | |___| |_  |  _|_  | | | |   |  ___|  ___| |  ___| |_  |_  |_|   |_____  |  _| |
| |___   _| |___|  _|  _| | |_  |_____|  _|___|  ___| |_  | |___  | |   |_   _| | |_|___| | |   |_  |  _|___  |_____  |_____|_____  |  _|   |
| |   |_|    _|   |  _| | |_  | |  _  | |  _  |___   ___|_____|  _|_  |___|_  | |_  |  ___| | |_____|  _____|   |  ___|  ___    | | |_____| |
|___|_  | | |  _|_| |  _| |___|_  |_____| |_____  |_|   |  _  |_   _| |  _____|_  | | |   |_|_____  |_|  _  | |_|_  |_______| | | |___  |  _|
|  _____| | | |  ___  |   |  _____|  _  |   |   |_____|___| |_  | |  _|___________| |___| |   |   | |  _|  _|___  |___________|_____  | |_  |
|_  | |   |_|___|   | | |_|_   _|  _|  _|_|  _| |  _  |  _    | | |_____  |  _|  ___|   |___|  _| |___|  _|  ___  | |  _   _|  _____  |_  | |
| | |_  |_  |  ___| | |_    | |  _| | |   |  _| | | | | |  _| | |___   ___  |  _|   | |___  |_  |_   _| |  _|   | | | | |_____| |   |_  | |_|
| |_  | | | |___  | | | | |_| |_  | |___| | |  _|_  | | | |  _| |   |_|   |_|_____| | |   |_  | | |_____| |  _|___| | |_     ___| | |___|_  |
| |  _| | |_   _| | |___|_____|  _|_  |  _| |___  | | | | |_  |___|_____|  _________| | |  _| |___________| |_    | | |  _|_|_  | |___  |  _|
| |_  |_____| |  _|_  |  _______|  _  |_  |  ___|___| |_|_  | |    _____| |  _  |   | |_|_  | |_  |  ___________| | | |  ___  |___|  ___| | |
|___________  | |___  |___    |  _  | | | | |   |   |_  |  _|___|_|  _____|_  |___|___|   | |_  |___|  _____  |___  | | |   |_   _|_______| |
|  ___  |_____|  _  |___  | | |_|  _|  _| |_| | | | |  _|  _________|  _  | | |  _______|___  |_______| |   |_  |  _| |___|_  | |   |  _    |
| |___  |  _  |___|_  | | |_|_  | |___|  _____|_  |___|  _|  _________|  _| | |_____  |_______|    _|   | |  _| | | | |___   _| | |_____| | |
| |   |___| | |  _____| | |   | |___   ___|   |___|   |_____|  _____   _|_  | |  ___  |  _______|_____|___|_  | | | |___  | | |___|  _____| |
|  _| |  ___| | |_   _____| |___|   | | |  _|_______|___  | | |  _  |___  | | | |   | |_____  | |  _   ___|   | |_______| |_  |_  |_  |  ___|
|___| |   |  _|_  |_  | |   |  ___| |_  |___  | |     | | |___|_  | |   |_  | | |_|___|    _| |_____|_  |  _| | |  _  |  _| |_  | |  _|_  | |
|  ___|_| | |_   _|  _|___| |_  | |_  |___  | |  _| | | |_________|___| |  _| |___   ___|_  |_  |  ___  |_  | |___| | |_  |   | | |_  | | | |
|_  |  ___|_____|  _________|  _|   | |  ___| |___| |_  |___   _  | |  _|_  |___  |___  | |  _| |   |___|  _| |  _  |_  | | | | |   | | | | |
|  _| |  ___   ___|  _  |  ___|_  | | |_____|___  | |_____  |_  |___| |  _____  |___  | | |_____|_|___  | |_____|  _| |___| |___| | | | |_  |
|_  |___|   |_|   |_  |___|     | | |___  |   |  _| |  _  |_  |___  | |_|   |_  |  _| |___  |   |  _  | |_  | |  _|_    |_________| | | |  _|
|   |  ___|_____| |  _|  ___| |___|_  | |___| | |   |_  | |  _|   | |_____|_  | |   |_  | |___|___| | |  _| | | |   | |_______  |___| | | | |
| | |_  |___    |___|___|   | |  _  | |  _  |___| |_  | | |_____|_  |  _  |  _| |_|_  | |_       _|  _|   | |  _| | | |  _|   | |  ___| | | |
| |  _| |  ___|___  |  ___| | | | | |___| |_  |_  |  _| |_  |_  |  _|_  |___| | |  ___|_  | | |_|  _|___| | |_  | | | |  ___| | |   |_  | | |
| |_|  _| |_    | | |   | | | | | |  _  |  _|_  |_|  ___| |_  |  _|_  |___  | | | |   |  _| |_______  |  _| | |___|___| |_  |___| |_  |  _| |
| |  _|_  |  _|___| |_| | |___|_  |_  |_  |   |_  |_________| |_____  |  _| |_____| |___|_  | |   | |_  |  _|_    |   | |   |_   _|  _| |   |
| |_  |  _|   |  ___|  _|   |   |_  |_  |_| |  _|___  |  _  | | |   | | |  _|   |  _|  _  |___| | |_____| |  ___|___|_| | |_  |_|  _| |___| |
|_______|___|_________|___|___|_______|_____|___________|_____|___|_____|_____|_______|_________|_________|_______________|_______|_________|
