_____________________________________________________________________________________________________________________________________________
| |  _______    |  _  |    ___________  |   |_   ___|  _   _|    _______  |   | |  _   _____  |_____   _____  | |  ___   _  |  ___  | |  _  |
|  ___  |  ___| | |  _| | |  _  |  _  | | |_  |_______|   |  _|___  |   |___|_  |_  |_____  |_____  |_  |_  | |___  |  _|  _| |   | |_____| |
| |   |_| |   |___|_  |_|___|  _|_  |_|___| |_   _______| |___  |  _| |___  | | | |_  |  ___|  ___|_  |_  | |___  |_|_  | |  _|_|_  |   |  _|
| | |_____| | |    _| |  _____|  ___|  _   _|  _|   | |  _|  ___|_____|  _| |_____|  _|___  |  _______|  _|_   _|_  |  _| | |  _  |___| |   |
| |___  |  _|_| |_______|  _   _|   | | |_____|  _| | | | | |_   _  |   |  _|  _____|   |  _| | |    _  |   |    _| | | | | | |  _|_  | |_| |
|___  | |_____  |   |_   _  |_|  _|_______  | | | | |_   _| |  _| |___| |_____|  _____|___|  _| | |_  |_| | | |_______|_____| | |   | |_  | |
|  _| | |  _  |_| |_  |_|  _|  _|   |   | |_  | | |_  |_|  _| |    _|  _|   | | |_____    | |  _|_  | |  _| |_   ___|  _______|___| |_  |_  |
|  ___|___| |_  |_  |_  |  _____| |___| |  ___| |_  | |  _|_  |_| |  _|_  |___|_  |   | |_| |  _____| |_  | |  _|  ___|   |   |   |   | |  _|
| |  _  |  _  |_______| | | |   | |_  | |_  |  _|   | | |   | |  _| |   |_____  |___| | |  _| | |   |_____| |  _|_  |  _|___|_| | |_| |___  |
| | |_  |_  | |   |    _|___| |___|   |_  |_|_____| |___| |___| |  _| |_  |   | |  ___| | |  _|___|    _|  _|_|  ___| |  _  |  _|_  | |   |_|
| |_  | |   |_| |_  |_|  _____   ___| | |_  |  _____|_   _|_   _|_____|  _| |___|   |   | |___  |  _| |  _|  ___|  _  | |_____| |  _|  _|_  |
| |  _|  _|_|   |___|  _| |   |_|   | |_  | |___________|   | |   |  _____  |   |_| | |_| |   |_  |___| |  _|   |_  | |___  |___  |_______| |
| |   |_|   | |_|   |___  | |_____| |_____|___     _______|___| |_____|   |_| |_____|_   _|_|  ___|  ___|_  | |_____|_  |  _|   | |  _  |  _|
| |_|_____| | |  _| |  ___| |     |___  |  _____|_|  _  |  _____| |  ___|_  |_______  | |   |___|  _|    _|___|  _____| |_____| |___|  _|_  |
| |  _____  |___| |___|  _| | | | |  ___|   |  _____| | | |_     _|_____  |___  |  ___|___|___  |   | |___    |  _______|___  |_  |_______  |
|___|  _____|_    |_____  | |_| | |_  |_  | | |  _____| |_  | |_  |  _  |___  | | |  _|  _______|_| | |   | | |_____  |     |_  |_____  | | |
|_  | |_   _____| |  ___  |_____|_  |_  |_|_  |_   _  |_  | | | |___|   |  ___|___|  ___|_       ___|___| | | |  ___| |_| |_  |  _  |  _|___|
|  _| |  _|  _  |___|  ___|   |  ___| | |   |_  |_|  _|   | | |  ___| |_| |  ___  |_____  | | |_|  _______| |___|   | |  _|  _|_  | |_  |   |
|   |___|  _| |___  | |_   _|_| |     |___| | |_  | |  _|_| |___|   |_  |___|   | | |  ___| |_____|   |  ___|  ___| |___|  _|   |_| |  _| | |
| |_______|_    |  _| |  _|  ___| | |_|  ___|  _|_  |_____________|___   ___| | | |___  | | |  ___  | |_  |  _|   |_  |  _|  _|___  |_  | | |
| |_____     _|_|_____| |  _|_____|_  | |___    |  _____|  _____  |   | |  ___| |___  | | | |_|  ___|_  |___|  _|_  |___|___    | |_  |___| |
|_____  | | |   |    ___|_  |   |  _  |___  | | |_  |  ___|  _  |___| |_| |___________| | |_____|  ___| |   |  _  | |_   _  |_| |  _|  ___| |
|  _|  _| |___| | |_  |  ___| |___| |_  | | | |   | |_  |_  |  _|  _|_  |  _  |  _______|_____   ___   _| | | | | | |  _| |_____| |  _|  ___|
| |  _| | | |   |_  | |_  |  _|   |   |  _| | | |_|_  |_____| |  _   _| | | | |_  | |    ___  |_|   |_____| |_  | |___|_   _|  ___  | | |   |
|  _|   | | | |___| |_  |___| | |___|___| | |_|_______  |  ___|___|_  | | | | |  _|_  |_  |  _|  _|_  |_____  |_| |  _  |  ___|   |___|_  | |
| |  _|___  | |  _____|___  |  _| |  _____|  _  |  _  | |___  |    ___| | | | |___  |___| |_____|  _|___  |  _|   | |_  |___|  _|_  |   | | |
| |_|  _  | |___|   |    ___| |  _| |  _  |_  | | | | |_   _|_  |_|   | | | | |_____  |  _| |   |  ___  | |_   _|_|_  |_______|  _|___| |_| |
|_____|  _|___|  _| | |_|   | |   | | | | |___|  _| |_  | |  ___|  _| | |_  |_____  | | |  _| | |___  | |_  |_|  _  | |  ___  |  ___  | |  _|
|   |  _|     | |  _|_  | |___|_| | | | |___  |___  |  _|_| |_  | |_____|___|  _   _|___|_   _| |   | |  _| |  _| |___|___  |___|_  | | |_  |
| |___| | | | | | |_    | |  _   _|___|     |_  | | |_______  | |_  |_   _  |_  |_|   |   |___|  _|___|_  | | |  ___|  _____|  _   _| |___  |
|_  |_____| |___|___  |_| |   |_|  _  | | | | | |___|  _  | |  ___| |  _|_____  |  _|___|___  |_|   |  ___|___| |   | |   |_  | | |  ___  | |
| |_  |  ___|   |___  |  _| |_  |_  |___| | | |_______|  _| | |  ___| |  ___  | |_  |   |  _|_____| |  _  |  _  | |___| |_  |___| |_  |___| |
| |  _|  _  | |___  | | |___  |_____|_  | |_  |  _|   |_  |___| |  ___| |   | |_  |___|  _|   |  ___| |  _|_  |___|  _  |___  |   | | |  ___|
| | |  ___| |_  | | |_|_  | |_  |  _____|   |___|  _|_____|  ___|_________|_|_  | | |  _|  _|___|  ___|_  |  _|_  | |   |   |___|_  | | |   |
| | |___|  _|  _| | |   | | |  ___|  _  |_| |  ___|_____   _|  ___________  |  _|___|_  | |  _|  ___|   | |___  |_  | |_| |_  |   | | | |_| |
| |___  | |  _|_  |___|___|  _|   | | |_  | | |_   _______|  _  |_   _|  ___|_______  | | |___  |  ___| |    _|_  | | |  _| | | |___|___|  _|
|  _  | | |___  |   |_    | |  _|___|   |_  |_____|   |  _| | |_  |  ___|  _  |  _  |___|___  | | |___   _|_|   | |_|_   ___| |___  |_   _  |
| |___|_  |   | | |_  | | |_|___  |  _| |  _|   |  _| |___   _|  _| |    _| |___| |_  |  _  | |_|  _  |_|   | | |___  |_|   | |  _|_  |_  | |
| |    _|___| |___| |___|_____  | | |___| |  _|___| |___  |_|  _| | |_|_  |    _____| |_  | |_  |_  |_  | | | |___  |_____|___|  _____|___| |
|___|_________________________|___|_________|_________________|___________|_|_____________|_____|_____|___|_______|_________________________|
