_____________________________________________________________________________________________________________________________________________
|  _   ___  | |  ___   _  |___   ___   _   ___  |_____   _|  _   ___|   |  _|   |     |  ___  |  _    |     |_   _  |_    |_   ___  |_   _  |
|  _|_  | | | |___  | | |___  |_|   |_  |_  | |_  |  ___|  _| | |  ___| |  ___| | | |_|___  |___|  _| |_| |_____|  _|  _|_____|   | |  _| | |
| |  ___| | |_   _| | |___  |_  | | |  _| | |_  | | |  ___|   | |_|   | |___  |___|_   _|  _|   |_  |_____|   |  _|  _  |  _|  _| |___|  _| |
| | | |  _______|  _|___  | |  ___| |_____|   |  ___| |  ___|_|_____| |___  |_______|_  | |_  | | |_  |  ___| |_  |___| |  ___| |_   _|  ___|
| | |_  |  _|  ___|  _|  _|___|   | |  _  |_| | | |  _| |  ___    |   | |  _|  ___   ___|  ___|___  | | |   | | |___  | | |_____  |_  | |_  |
| |_  |___|  _|_   _  |_  |  ___| | |   |  ___|_  | |_______|  _| | |___| |  _|_  | |  ___|  _  | | |___| |___|  _  |___|_  |   |   |___|   |
| | |___  |___  |_|  _  |___|  ___| | | | |  _  |_| |  _   ___| | | |  ___|_    |___| |   |_  | |  ___  | |    _|___  |_  |___| | |_|    _| |
| |___  |_   _| |  _|_  |  ___| |  _| | | | | |_____| |___|   |___| |_____  |_|___   _| | |  _| |_|   |_| | |___  |  _______|  _|  ___|_  |_|
| |   |_  |_____|___  |_| |    _|_  |_| | | |   |___   _  | |___  |___    |_____  |_____| | | |_____|_  | |___  | | |  _______| | |___  |_  |
|___|_____  |___   ___|  _|_|  _____|  _| |___|___  |  _| |_  | | |  _  |_______| | |  ___| |_________  | |   |_| |_| |  ___  | |___  | |   |
|___   _  |___  |  _  |___  |_________|___  | |   | | |  ___| |_  | |  _|  ___  | |  _|   |_  |  ___  | |_  |_  |  ___|___  | |___   _| | | |
|  ___|  _|   | |___|    _|_____  |  _  | | | | |___| | |   |_  | | |___|_  |  _| | | | |_  | |___  | |_  |_|  _|_  |_    | |___  |___  | |_|
|   |_______| |___  |_|_  |  _  | | | | |_____| |  ___| | |_  | |___|  _____|_____|_  |_  | |_______| | | |  _|  _|_  | | | |   |___  |_|_  |
| |_____  |  _|   | |  _  |_  |___| | | |  _____| | |  _|_  | |_______|   |  _   ___| | | |___________| |___|  _|   |___|___| |_    | |   | |
|  _|   | |___  |_| |   |___|_______| |___|_    |___|_   ___|_________  | |_  |___  | | |___  |___    |  ___  |  _|_   ___  |___| |_| | | | |
| |  _|___|  ___|  _| |_______    |  ___    | | |  _  |_____  |   |   | |_  | | |  _|_____  |___  | |_|___  |___|_  | |  ___|   |_  |___|_  |
| | |   |  _|   |_  |___  |   | | | |_  | |___|___|  _|   |___| | | | |___|_____| |  _______|  ___|  ___  | |      _| | |  ___|_  |___  |  _|
|_|_  | |_____|___|_  |  ___|_| |_|_  | |_______  |_____|_  |  _|___|_________  | |___  |   |_  | |___  |___|_| | |  _|___|  _  |_____  |_  |
|   |_|   |   |  _____|___|   |___  | |  ___|  ___| |    _|___|   |  ___|     | |  ___  | |_  | |  _  |_____  | | | |    _| |  ___  |  _|  _|
| |_  |_|___| |_  |  ___  | | |   | | |  _  |_  | |  _|_____   _|___|   | | |_| | |   |_| | |___|_|  _______| | | | | |_  | | |___  |_  | | |
| | | |   |   |  _| |   | | |___| | | |_|  _  | |_  |  _  | |_  |  ___|___|_____|_| |_  | |_____    |   |   | | |_| |_|  _| | |   |_|  _| | |
| |_____|___| | |  _|_| |___|   | |_______|  _|_  |___|_____|  _| |  _  |_   ___  | | | |_____  | |_| | | |___|   |_  |_____|___|___  | |_  |
| |   |  _  |_|___|  _______| | |_  | |  _____|  _|  _____  |_  |___|  _|  _| |  _| | |_  |  ___|  ___|___|_____|_  |_  |  _______  | | |  _|
| | | | | |___  |  ___________|_____|_____|   |_   _|   | |_  |  ___| |  _|   |_____| |  _|_  | |_  |___   ___  |  ___| |_  |  _  | |___| | |
|  _| |_  |_  | | | |  ___   _  |  _  |  ___|_  |_  | |_____| | |  ___| |  _|_  |___  |___  | |  _|_______| |  ___|  ___  | |   |_|___  | | |
| | |   |_  | |___|___   _| | |___|  _|_  |  ___| | | |  _____|_  |_   _|___  |___  |_    |___|_   _____  |  _| |  _|   |_| |_|___    |___| |
|___| | | | |_____    |_|  _|   | |_  |  _|___  |  _| |_______  |_  |_____  |_  | |_  |_|_   _  |_  |  _  | |  _|_  | | |  _|   |  _| |___  |
|   | |  _| |  _____|_____|  _|___  |___|_    | |_________  |  _| | |  _____|  _|  _| |   | |  _|___| |_  | |  _  |___| | |  _| | | |___  | |
| |___|_|  _|  _  | |  _  |   |_____  |  ___| |_________  |_| |_  | | |_   ___|_  |  ___| | | |  _  |_  | | | | |   |  _| | |_____|  _|  _| |
| |  _____| |  _| | |_  |___| |  _  |___|_________  |   |_  |   | | |_  |_   _  |___|   |___| |_  |_   _|_| | | | |_|_  | |  _  |___  | |   |
|  _|   |_   _|  _|  _|_  | | | |  _|   |  ___  |_  |_|_  | |_| | |_  |   |___|_  |  _|___  |_____|  _|  ___|_  |_   _|___| | |___  |  _|_| |
| |_  |_  |___|   |_  |  _| | | |_  | | |___  |_  |_______|_____|_  | |_|___    |___  |   |___  |  ___| |_  |  _| |_  |  _____|  ___|_____  |
|_____| | |   | |_  |  _|  _| |_  |___|_______| |_  |  _   _____  | |_____  | |___  |_| |___  | |_|  ___|  _|_   ___| |_  | |  _|  ___    |_|
|  ___  |___| |_|  _| |  _  | |  _| |    _|     |  _| | | |  _______  |  ___| |  ___|  _|   |___|  _|  _|  _____|   |_  |_  |___  |   |_|   |
| |   |_____|_____|  _|  _| |___|_   _|_   _| | | |  ___| |  ___|   | |_  |_  | |___    | |___  | |_  |  _|_    | |_______| |   | | |_  | | |
|___|_  |    _____| |_  |  _  |   | |   | |  _|_| |_  |  _|_|  ___| |___|_  | |___  | |___|   | |_  |_________| |_______  | | | |_| | | | | |
|  _  | | |_____  |_  |_|_  | | | |_| | |_| |    ___| | |   |_  | | |  _____|_|  ___| |   | | |_  |___  |  _  | | |  _  |___| |_  | |  _|_| |
| |_____| |   | |_____|   | |___| |  _|___  | | |  ___|___|_  |_  | | |  _    | |   | | | | |_  |___  | |___|_  | | | |_  |  _|  _| |_____  |
|  _______| |___  |___  | |_  | | |_  |  ___| |_|___  |___  |_____| | |_|  _|___| | |___| |___|___  |___|  _  |___| |   |___| | |  _|  _____|
|___________|___________|_____|_______|_____|_____________________|_______|_______|_______________________|_________|_|___________|_________|
