_____________________________________________________________________________________________________________________________________________
|  _  |___  |    _|  _  |     |  _  |    ___|  _    |  ___  |  _|  _   ___  |   |_    | |  _   ___|  _______   _|  ___    |  ___    |  ___  |
| |_  |  _  | |_  | | | | | |___| | |_| |   |_  | |___|  _|_  |  _| | |___  | | |  _|_  | |  _|   | |   |  _  |  _|_  | | |_  |  _| |_  | | |
|   |___|  _|_  | | | |___| |  _  |_  |___|_____| |  _  |   | |___  |___  |___| | |   | | |_  | |_____|_|_  | | |  _  | | | | |_  | |  ___| |
| |___  |_|  ___| | |_  |  _|_  |_  |_____  |  ___| | | | |___|  _|_  |  _|_  |___| |_| | | |___|_  |  _____| |  _|___| |  _| | | |_|  _|   |
|  ___|_____  | | |_  | |_  |___  |___________|_____  | | |  ___|  ___| |    _____|  ___|_  | |     | |___  | | |  _____| |  _| |_____|  _|_|
|_|  ___  | |_  |_________|_  |  _| |  _____  |   | | | | |___  | | |  _|_|_____  | |  _____|  _| | |___  |_  | |_  |   |_|_  |  ___  |___  |
|  _| |  _|  _______|  _______| |_  | |_   _|___| |  _|___|  ___| | |_  |  ___  | | | |  ___|_  | |_   _|_  | |_  |___|_______|___|   |  ___|
| |___  | | |  _______| |  _________|_  |_   _|  _|_  |_   _|   |_   _| |___  | |___| | |  _____|_  | |  _  |_|  _|  _   ___________|_|___  |
|___  | |___|   |  ___|  _|  _____   _|___  |  _|   |___  |  _| |  _|   |   | | |   | |_____   ___| | | |___|  _|  _| |_  |  ___________  | |
|  ___|___  | | | |   | | |___  | |_________| |  _|_   _| |_  | |_  | |_| |___|___| |_____  |_|  ___| |_______|___  |_  | | |  _  |___  | | |
|   |___  | | | |___|_______|  _________|  ___| |_  | |  _|  _|_____|_____|  _|   |___  |  _|  _|   |_______  |   |_____| |___| | |   | |_  |
| |___  |  _|_| |  ___  |  ___|  _________|_________|_  | | |    _  |___  |  ___|_    | | |  _|___|   |  _  |___| |  _  |  ___  |___| |  _| |
|_  | | |_____  | |   |___|  _|_    |  _  |   |  ___  |___| |_| | |_  |   |_   ___| | |_____|   |  _| |_  | |   | |_  | |___  |___  | |___  |
| |_  |_  |_  | |___|___   _|   |_| |_  |___|___|   |___  |_____|   | | |_|  _|  ___| | |  ___| |   |_  | | | | |_  | |___  | |   | |___  |_|
| |  _|  _|  _|_  |  _  | |  _|___   _|_  |_______|  _  |_  |  ___| | |  _____| |   |  _|_  | | | | |_  | |___| | |___|  ___|___| | |   |_  |
|  _|   |___    |___|  _| | |   |_  |  ___|  _______|___  |___|   |___|___|  ___| |___|   | |  _|_|   |___|_____  | |  _|  ___  | | |_|  _| |
|_  | |_|   | | |  ___|  _|___|_  |_|___  |___  |  ___  |_  |   |___   _____|  _|_  | | |___|___  | |_______  | | | | |  _|   |___|___  |  _|
|  _|_____| |_| | |  _| |  ___|   |  _____|  ___| | |  _|  _| |_  |_  |  _  |  _______|___  |  ___| |  _____| |  ___|_  |  _| |  ___  |_|_  |
|_  |  _  |   | |_  |  _| |   | |_|_  |  _  |  _____|_  | | |_  |_  |_|_  | |_|   |  _______| |___  | |    ___|___|   | | |  ___|  _| |  _  |
| | |_  | | | |_____| |_____| |_______|_  |_____|  _____| | |  ___|_    | |_   _|___|  ___  |___  |___| | |  ___  | | | | |_|   |_______| | |
|___|  _| |_|_   _  |_____  |   |  _    | |   |  _|   |  _|___|  _  | |_|_  |_|   |_____  |___  |___  | |_| |  _|___|___|_____|___  |  _____|
|   | |  _|   | | |___  |  _| | | |  _| |___|_|_____| |_   _____|  _|___  |_  | |_____  | |   |_  |  _|___  |  ___  |  ___  |  _   _|_____  |
| | | |_  | | |___|  _  | |  _| | | |___  |  _____  | |___|  _  |_  |   | |  _| |  _   _|___|_  |___|  _  | |_|  _  |_  |  _| | | |  ___  |_|
| |___  | | |_  |  _| | |___| | |_|___  | | | |  ___| |  _____|_  |___|_  |_  | |_  | |  _  |___  |  _| | |_  |_  | |  _|_  | |  _| |   |_  |
|_  | |_| |   |___|_  |_  |_  |_________| | | |_  |  ___|_  |  ___|_  |  _| |___|  _| | | |_  |_  |_  |  _|_______|_| | |  _| |_|  _| |_____|
|  _|_____|_| |  _  | |  _|   |_____  |  _| |  ___|  ___   _| |  _____| |  ___  |_  |_|___  |_  | |  _|_  |   |  _____|  _|___   _| |_  |   |
| |___   _____| |  _| |  ___| |   |  _|_____|_  |___|   | |  _| |  _  |___|  _| |   |  _  | |  _| | |_  |___| | |  _  | |  _  | |   | |___| |
| |  _  |   |  _|_  |___|   |_  |___|     |   |_______| |_|_  |  _|  _|  _  |  _| | |_  | | | |_____|  _  | | |___|  _|___| | | | |_  |   | |
| | |  _| |___|_  |___  | |_  |_|  ___| | |_|_____   _| |  ___|___|  _____| |_  | | |  _|___|_____  |_  |___| |  ___|_  |  ___| |   |___| | |
| | |___| |   |   |  ___|_  |_  | |   | |_________  |  _| |  ___  |___  |  _|  _| |_|_  |  _____  |_  | |   | | |  ___  |_  | | |_|_  |  _| |
| | |  _____|___| | |  _______| |___| |_  |_   _____|  ___|   |  _|_  | |_  | |  _|  ___| |  _  |_  | |___|_____| |   | | | |_  |  _  |___| |
| |_  |  _|   |___| |_  |  _____|   |_  |_  |_  |   | |   |_| |___  |_   _|___|_  | |___  | |  _|  _|_  |   |_  |  _| |___|_  |___|  _|   | |
|_  | | |  _|_______|  _|_________|_   _|  _| | | |___| |_  |___  |_  |_|  _______| |   | | | | | |   |___|_  | |_  |___  |  _|  ___| | |___|
|  _|___|_  |  _______  |   |  ___  |_  | |  ___| |_  |_  |___  | | | |  _|  ___  |___| | | | |_  | |_____|  _|  _| |  _|___|  _|___  |___  |
|_  |  _  |_  |_  |   |_| |___|  _|_  |_| |_|  _________| |   |___|  _|   |_  | |_____  |___|_  |___|  _____|  _____| |  _____   ___   ___| |
| |___| |_  | |  _| | |  _|_  |    _|_  |   |_  |  _  |  _| |_  |  _|  _|_______|  _  |_____  |___  | |_    | |  _  |_____|   |_|   | |  _  |
| |  _  |  _|_  |  _| |_    |_  |___  | | |_____| | | | |_____|___  |_____  |  ___| | |   | |_____  |_  |_| |___| |_________| |  _| | | | | |
|_____| | |  ___| | |_  |_|   | |_  |___| |  _|  _|  _|  _  |   | |_  |___  |___  | |___| |  _  |  ___| |  _|     |    _____|___|  _| | | | |
|  _____| |_|  ___|  _|_  |_| | |  ___  |___|  _| | |_____|___| | |  _|   |_|  ___|    _| |___|___|  ___| |  _| |_| |_______   _| |___| |  _|
|_____________|_______________|___|___________|_________________|_______|_____|_____|_______________|_________|_____________|___________|___|
