_____________________________________________________________________________________________________________________________________________
|___   ___  |  _  |_    |_   ___|    ___  | |  _  |  _____  |  _____  |  _____|  _______   _______    |   |    _______|   |  _____    |   | |
|   |_  |  _|_  | |  _|_  | |   | | |_______| | | | |     | |_____  | |_________   _|   |_  |     | |_| |___| |  _______|___| |  ___| | |___|
| |_  | |_______| |___  |  _| | | |___  |   |_  |___| | | |_________|_  |  ___  | |  _|_  | | | |_| |  _|_  | |___  |   | |   | |   | |___  |
| | |___|  ___________  |_|  _|___|_  |___| |  _|___  | |_____|  _____  | |_  | |_| |  ___| |_| |  _| |  ___|     |___| |___| | | |___|  ___|
| |_________|   |_______|  _|  ___   ___  |___|_    |_|_____  |_  | |  _| |  _|_____| |_____  | |_  |_  |   |_| |_____|_  |   | | |  ___|   |
|_____  |  ___|_______  | | |___  | |_____  |  ___| |  ___  |   | |_____| |   |  _  |___    | |   |  _| | |___  |  ___  | | |_| | |___   _| |
|  ___  |_____  |  _  |___|_    | |_____  |___|_   _| |_______| |_________|_| | | |___  |_| |___| |_____|___  | |  _|  _|_  |  _| |   |_  | |
| |  _______  | |_  | |_     _|_| |   |   |  _  | |_____  | |  _|_    |_   ___| |___  |_____| |  _|___  |  ___|_| |   |  ___|_  |___| | | | |
| |_  | |   |_|_____|_  | |_______| |___| | |  _|_  |  ___|_____  | |___  |  ___|   |  _  |_  | |  ___  |_____   _| |_| |  _|  _| |  _| | | |
| |  ___| |_____    | | |_|  ___  |___  |_| | |  ___| |   |  _  | |___  |_| |  ___|___| |___  |___| |  _|  _  |___|_  |_  |  _|   | |  ___| |
| |___|  _| |  ___|_  |_____|  _|___  |_____| | |   |  _|___  | |___  | |  _|_  |_______   ___|    _|_  | | |_____  |   | | |_  |___|_____| |
|___  |  ___| |  _|  _|_______  |   | |  _____|___| |_|   |_  |_  |_   _|_  | |_   ___  | |  ___|_   _| | |   |  _| |_| | |_  |___________  |
|   |_  |  ___| |  _|   |    ___| | |___|   |___  |_____|_  | | |_  |_|   | |_  | |   | | |_______| |  _| | |___|  _|  _|_  |___  |  _  |_  |
| |_  |_|_  |  _|_   _|___|_|  ___|   |_  |_______|     | | | |  _|_____| |_  | |___|_| |_____  |   |_  | |___   _____|  ___|_  | |_  |_  | |
|   |_  |  _|   |  _|  _______|  ___|___  |  _  |  _| |___| | |___    |  _  | |_____  | |  ___| | |_  | |___  |_|   |  ___   ___|   | | | | |
| |_  |___|___| |_  |___  |   |_  |   |  _| | |___| |_______|_______| |_  | |_________| | |  _____|___|___  |_  | |___|   | |   | |_|_  | |_|
| | |_______  |  _|  ___| | |_  | |_| | |  _|_   _____   ___   ___  | | | | |   |___    |  _|  _____  |  ___|   | |  ___| |_| |___|  ___|_  |
| |   |   |  _|_____|  ___|_|   |_  | | |___  |___  |  _|_____|   |_|_  | | | |___  |_| |  _|_  |   | | |  ___| | |_  | |___  |  ___|  _  | |
| | |___| |_  |  _____|   |  _|_  | |___  | | |  _| |_____  |  _|_  |  _| | | |   |_  | |_|  ___|_| |___| |  ___|_  | |___  | |___  |_  | | |
| | |  ___|   |___  |_  | | | |  _|_  | | | | |_______  | |___|   | | | | |___| |_  | | |  ___   ___|   | |_   _|  _|___  | | | |  _|   |_| |
|___| |   | |_____| |  _|___|  _|  _| |___  |_______  |___  |  _|_|___| | |   |_  | | |_  |   |_|  ___| | |_  |  _|  ___| |_____|_____| |   |
|   |___|_|_____  | |_   _  |_  |_  |___  | |___    |___  | |_   _    | |___| |___|___  |_| | |  _|  ___|   |_|_  |_    |_  |    ___|  _| | |
| |_____  |  _____|_  |  _| | |_  |   |  _| |  ___|_|   | |_  |___| |_  |   | |  _  | |_____|___| | |  ___|_   _|_  |_| |  _| |_______  | | |
| |  _  |___|  _  |  _|_|  _|  _____| |_  |___|  _  | |___|_________|_   _|_|___  | | |      _____| | |___  |___________|___  |  _  | | | | |
| |_  | |   | | |___|    _|_____|   |_  | |   |_  |___|_    |  _____  |_|  _  | | | | | | |_|  _____| |  _  |  ___|  _____  |_|_  | |___| |_|
|_  | |___| | | |   | | |  ___  | |_  |_|___|   |_  |  ___| | |_   _|_____| | |_  | |  _|_  | | |   |___|  _|_  |  _|___  |_______|___  |_  |
|  _| | |  _| |___|___|  _|   |_____|_  |   | |___|___|   | |_  | |  _   ___|_  | | | |   |___|___|  ___| |  _  |_  |  _  |___   _  | |___  |
|  ___| |_  |_______  |  ___|_____|   |___| | |    _|   | |_____|  _| | |  _  | | | |___| | |    ___|   | |_  |_|  _|_  |_______|_____|  ___|
|_  |_    |_   ___  | | |  _   _____|  _____|___|_____| |___  | | |  _| | | |___|_| |_   _|_  |___  | | |_   _|  _|_   _|  _____  |  ___|  _|
| |_  | |_|  _|_   _| |_|   | |  _  |_|  _  |  _____  |_  |  ___| | |  _|_  |  _  |_  |___  |___  |___|  _| |  _|_    |  _|___  | |___  |_  |
|  ___| |   |   |___|_  |_| |_| | |_  | | |___|  ___|   | |_  |  _| |_    |___| |_____| |  _|  _|_   _|_____|___  | |_|_______  |_  |  _|  _|
| |  ___| |_| |_  |  ___|  _|  ___|   |___  |  _|  ___| | |  _| |  _  | |_  |___   ___  | |_________|  _____  |  _| |     |  _| | |___|  _  |
| |_  |  _|  ___| | | |  _  | |  ___|  _|  _|_  | |_   _| |___| | |_  | |_________|  _| |_  |  _  |  _|  _____|_  |  _| |_  |  _|_    | | | |
| |  _|_  | |  _  | |_  | |___| |   |_|  _|  _  |_  |_  |___  | |_  | |___  |  _|  _  |_  |___| | |_  | |  _______|_  | |_  | |   |_|___  | |
| |    _|___|_  |_|_  |_  | |  _| |_____|___  | |  _|  _|_  |___|  _| |  ___|_  |_  |_  | |_  |  _|  _| | | |  ___  | |_  |_|___|___  | | | |
| |_| |  ___  | |   |_  |  _|___________  |   |_|_  |_  |  _______| | |_____  |_____  | |_   _| |  _| |___|  _| |   |_  |_  |    ___| |___| |
|_  | | |  _  |___|_____|_|  ___  | |  _____|_|  ___| | | |  ___|  ___|  ___|_  |   |_| |  _|  _| |  _______|_  | |_  | | |___|_  |  _|  _  |
|  _|___|   | |  ___     ___|   | |  _|  _______|   |  _| | |   |_  |_____   _| | |_  |_____| |_  |___  |   |   |_  |_|_____  | | | | |   | |
| |  _  |_| | |_|   |_| |  ___|___|_|  _| |    _| | |_  | | | |_  |_  |  _  |  _| | |_____  |_____|   |___|___| | | |  _   _|_  | | |___| | |
|___|_______|_____|_____|_____________|_____|_____|_______|_____|_______|___|_____________|_________|_____________|_____|_______|_________|_|
