_____________________________________________________________________________________________________________________________________________
|   |  _   _____   ___|     |_  |  _______    |_    |   |  _  |  _   ___   ___|  _   _|     |  _____  | |  _   _____  |___    |  _________  |
| | |_  |_____  |_|   | | |_  | | | |  _  | |_____|___|___|  _|___|_  | | |  ___| |_____| |___|  _  |_  | | | |_  |  _|   | | |_  |  _|  _  |
| |_____|     |_____|___| |  _|  _| | | |___|_    |  ___  |_   _______|___| |  ___|    _|___  |_  | | | |_  |_  |___  | |___|_  |  _|  _| | |
|_  |   |_| | |   |  _____| | |_   _| |  _    |_| | |  _| |  _|  _____  |  _| |  ___|_   _  |_  | |___| | | | |_  | | | |   | | |_|  _|   | |
| | | |  ___|_| | | |  _  | |_   _|  _|_  | |___  |_  |  _| | |_  |   |___|_____|   |  _| |  _| |   |  ___|  ___| | |___| |  _| |  _|___| | |
| |___| |  _____| | |   |_|_  |_  |___  | |_  |_____| | |  _____| | |_____   _  | | | |_____|  _| |___| |  _|  ___|___   _| |  _|  ___  | | |
|  _|  _|___  | |___| |_   _| | |_  |   |___|___    | |___|   |  _|_   _|  _|_____| |  _  |  _| | |  _  | | |_______  | | | | | | |   | |___|
| |  _|   | | |   |  _| |_____|___  | |_|  ___  |_| |  ___| |___|_____|  _|  _  | | | |   |_  | | | |___|_  |    _|  _| |  _| | | | | |___  |
|_______|___| | |_| |    _______  |_|_______  |_  |___|  ___|_   _  |  _|  ___| |  _| | |_  | |_____|  _  | | | |  _|   |___| |_____|_  |  _|
|  ___   _____|_  | |_| |  _____|_____  |_   _| |___  |_____  | |  _| |  ___|  _|_  |_|_  |_| |  _  | |  _| | | | |  _| |   |___  |  ___|_  |
|  _  | |  ___  |___  | |  _  |    ___|_  |_______  |  _|   | | |___  | |  ___|   | |  _  |  _| | | | |_____|_| | |___|  _|___  | |  ___  | |
| |  _|_| |  _|___  |___| | |___|_  |   | | |   |  _| |  _|___| |   |_| |_  | | |___|_  |_| |  _| |___|_____    |___  |_  |   |___|_|   |_| |
| | |  ___| |  _____| |  _|   |  _| | | | | | | | | | | |  _____  |_____|  _| |_____  | |  _| |  _____    |   |_____| |  _| | |___   _|___  |
|_| | |    _| |  _|   |_  | |___|  _| | | |  _|___| | | |_|  _  | |  ___| |___    |  ___|_____| |  _____|___| |  _____| |  _|_______|___  | |
|  _| | | |  _|  ___|  _| | |   | |  _|___| |_    | | |_  | |_  |___|   |  _  |_|  _| |  _______| | |   |  ___| |  _  | | |   |  _____  |___|
| |  _| | | |_______|_____  | | | | |_   ___|  _|___|_  | |   |___  | | |_  |_  |_____|_  |___  | |___|_  |   | | | |___| | | |_  |   |___  |
|  _|___| |_____________  |_| | |___  |_______|  ___   _| | |___  |___| |___|  _|  _______|  ___|_____  |_| |___| |  _  | | |  _|___|___  | |
| |    ___  |_    |    _| |  _| |   | |  _____  |_____|  _|___  | |  _|___  |  ___|_   _______   _____|   |___  |___| |_  | |_______   _| | |
| | |___  |_  |_| | |_  |___| |___| |  _|   |_  |  _  |___  |___| |___  |  _| |  _  |___|  _  | |  _  |_|   | | |_  |  ___|_______  |_____| |
| |  ___|_  |_  |_____|_    |_  |   |_|  _|_  |_| |   |  ___|   | |  ___| | |___| |_  |  _| |_  |_  |_____|_  |_  | |  _____|    _|___  | | |
| | |  _____|___   _______|_____| | |  _|   | |  _| |_| | |   | | |   |  _|  _|  ___  |_  |_______|___  |_  | |  _|___|  _____|___________| |
| | |_  |  _  |_  |   |   |  _  | |_|_  | | |___| |_  | | | | |___| |___| |  ___|   |_  | |  ___  |   |_  | | | |   |  _________________|   |
| | | |___| |_  | | | | |___|  ___|   |___| |___    |___|_  | |  _| |___   _____| | |  _| |_  |  _| |_____| | |___| | |  _____  |  ___  | | |
| |_________  | |_| | | |_   _| |  _|_______|   | | |_    |_| |   |___  | |  _____| |_  |   | |_  | |  ___  |_  | | | |_  |  _|___|   |___| |
|_________  |_|_____| |_  |_____|_____________|___|_____|_____| |  ___| | | |  _  |_  |___|_| | |___|_  | |_______|___|  _| |   |  _|_    | |
|_  |  _____|  _______  |_________   _  | |  _   _|    _  |_  | |_______|_| |  _|_  |_________|  _____| |  _|  _  |  ___|_____|_____  | |_| |
|  _| |_______  |_    |_____  |   | |_____| | |_____|_  |___  |_  |  ___   _| |  ___  |___   _|  _  |  _|_  | | | | |   |  _______  |_|_  | |
| |  _|   |  ___|  _|___  |  _|_| |_________|    ___  |_  | | | | |_|   | | | |_  |___   ___|  _| | |_   ___| |_____| | |___  | |  _______| |
| |_____|___|    _|___   _|_________  |   |  _| |  ___|  _|_____|_  | |___| | | | |   |_|  ___|_  |_____|   |_  |  ___| |  ___|  _|   |  ___|
|  _  |  ___  | |  _  |___|  _    | | | | |___| |_  | | |  _  |  ___|_  | |  ___| | |_____|_    |  _|   | |  ___|  _|  _|  _  |_|  _|___|  _|
|  _| | | |  _|_|_  |_______|  _|___|___|_______|  ___| |_  |___|  _  | |  _|  ___|  _________| | |  _| | |_|   | |  _|___  |_____| |  ___  |
|_|  _| | |___   _|  _|  ___  |  _______   _  |  _|   |  _| |  ___| |___|_  |_______|   |   | | |  _|   |_____| | |_  |   | |_____   _|_  | |
|  _|  _|  _  |_____|   |   |_|_  |    _| |  _| |  _|___|  _|_  |  _______| |  _______| | | |  _|___| |_  |_  | | | | | | |_____  | |    _| |
|_  |_  |_  | |   | | |_| |_  |  _| | |  _|_|  _|_________|  ___| |  _  |  _|___  |   |___| | |    ___| |___  | |  _|___| |___  | |___|_|  _|
|  _|  _|  _|___|_  | |  _|  _| |___| |___  |_____  |  _____| |  _____|  _|    ___|_|  _____|___| |   |_______|_  |  _  |_  |  _|_  |   |_  |
|  ___|_____    |___|___|  _|  _______  | |_______  | |___  |  _|  _  | | | |_|  _  | |   |  _  |_| |_  |  ___  |_|   |_____|___  |___|_  | |
| |    ___  | |_____   _|_____|  _  |_______|  _  |  _|   |___|  _| | |_  |_  | | | |___|___| | |  _| |___|_  |_  | | |  ___  |   | |  ___| |
| |_| |   | |  _____|_    |  _|_  | |  _  |  _|  _|_|  _|_  |  _|_____  |___|  _| | |_     ___| | |  _  |  _  | | |_|___|   | | |___| |_    |
| |  _| |___|_|   |  ___| | |_  | |___| | |_  |___  |_  |  _|_____  |  _|   |_____|_  | | |   | | | |_____|_____|_________| | | |   |_____| |
|___|___________|___|_________|___|___________|_________|___________|_____|___________|_|___|_____|___________________________|___|_________|
