_____________________________________________________________________________________________________________________________________________
|  _________   _____|  _    |___   _  |  ___   _________  |   |   |  _____________   _______|   |  _____   _  |___     _____  |    _|  ___  |
|_____  |   | |  _____  | |___  |_|  _| |   |  _____|   | | |___| |_______  |   | |_______  | |___|  _____| |___  | |_  |  ___| |_____|   | |
|   |  _| |___| |  _  | | |  _|_  | |  _| | |_|  _____| | | |_  |  _  |   | | |_  |   |  _  |_  | | |___   _|  ___|_  | |_|  ___|   |  _|_| |
| |_| | |_______|_  | |_| |  _  | | |_  | |_____|  _  |  _|___  |_  | | |___| |  ___| |_  |_  | | |___  |___  |  _  |_|_  |_  |   |___|   | |
| |  _|_____    |  _| |  _| | | | |___  |___  |  _| | |_|   |  _|  _| | |  ___| |   |_  |_  |_| |_  |   |   |___|_____  |   | |_| |    _|_  |
|  ___________| | |_  | |  ___| |___  |___  |___|   |_____| | | |_  |_| | |___  | | | |_  |_____|  _| | | |_____  |  ___| | |___  | | |   | |
|  _|   |  _  | |_  |___| | |  _  | |___  | |   | | |   | | | |   |_____|___  |_| | | |  _|  _____|  _|_| |_    | |___  | |___  | | |_| | |_|
|_|  _| |   |_|_  | |_  |_  |_  | | |  ___|___|___|___|___| |___|___  |  _  | |  _| | | |  _____  |___________| |___  |___|_____| |_____|_  |
|  _|  _|_|  _  | |_  |_  |_  | |___| |_   _____  |  ___  |_  |  _____| | | | | | | | | |_____|   |_  |   |   | |  _|_____________|  _  |  _|
|_  |___  |_  | |_  |_  | |  _| |  ___|  _| |  ___|_  |  ___  | |_____  |___  | |_  |_  |  _____|___  | |___| | |    _  |  ___  |  _|   |_  |
| | |  _|_  | |_____|  _|___|   |_  |  _|  _|  ___  | | |   | |_____  |___  | |_  |_  |___|  ___   _| |_  | | | |_|_  |___|___  |_  | |_  | |
|  _| |   | | |   |  _|_   ___|_|  _|   | |  _|   |___| | | |_  |   |_  |   |_|  _|  _| |   |_____|  ___| |  _|_____  |  ___  |_  |_|_  | | |
| |_  | |___| | |___|   |   |  ___|  _| |  _|  _| | |  _| | |_  |_| |  ___|_|  _|  _|  _| |_________|  ___|_  |  _  | | |   | |___  |  _|_| |
|_  | |_  |_  |_  |  _| |_| |___  |___| |___|_  | |___|  _|_  | |  _| |  _____| | | |   |___  |  ___| | |  ___|_  |___| |_|_____  |___|   | |
|  _|_  |___| | |_____| |  _  |  _|   | |  _  | |_  |  _|   | |___|  _|_  |  _____|_  |  _|  ___|  ___| | |___  |_  | |_____  |  _|  ___| | |
|___  |  _  | | |   |  _|   |_|_  | |_  | | |___| | |_  | | | |  ___|  _| | |  _    |_| |  _|  ___|  ___|___  |_   _____|   | | |  _|   | | |
|  _| |___|___  | |___| | |___  | | |___| |  ___  | |  _|_| | |___  | |  _| |___| |_  |___|  _|  _  |   |   |_  |_|   |   |___|  _|___|  _| |
| |  _|  ___  |_| |_   _| | |  _| |_  |  _| |_  | |___|   | |___  |  _| |  _|  ___| |_______|  _|  _| | | | |  _|  _| | |_|   |_|  _  | |_  |
| | |  ___  |_  |_  | |  _| |_____|   |_  |_  | | |    _|___  |  _| |  _| |  _|_______    |_  | |_  | |___| | |  _| |_  |  _|_______| | |   |
|  _|_   _|_  |_____| |_____  |_   _|_  | |_____|_  | | |  ___| |  _| | |___|   |  _____|_  | |_  | |___  |___| |  _____|___  | |    _|___|_|
| | |  _|  ___|___   _|  _______  |_____|___  |   |_| |_______|_____| |_____  |___|  _____| |_  | |_  |  _|___  | | |  ___  |_  | |_|   |   |
| |___  | |  _______|  _|  ___  |_|  _____  |___| |  _|  _____________|   |  _|  ___  |  ___|  _|  _| |_____  | |  _|_  |  _|  _|_____|___| |
|___  |_| |  _  |  ___| |_  | | |  _|  ___|_  |  _| |  _|   |   |   |_  |___|___|   | |_  |_    |___  |  _____| |_|  ___| |  _|___   _    | |
|  ___|  _| | | | |  _    | | |___|_____    | | |   | |  _|___|___|_____|  _    | |_  | |_  |_|  _  | | |_     _|  _| |  _|_____  |_|  _| | |
| |    _|_____|_  |_|  _| | |   |  _  |   |_|_____|_| | |  _  |_   _|   | | | |___|_____  |_  |___| | |_  | |_____|_  |___________  | |___| |
| |_|_  |  ___  |_____| | | | |___|  ___|_|  _  |  ___|  _| |_  | |  _|___| |_______  |_____|_______|_  | |_________  |    _|  _  | | |   | |
|___  |  _|_  |___  |___  |___|  ___|  _  |_  |___|_________|  _|  _|  _____   ___  | |   |  ___________|_  |  _  |  ___|_|  _| | |___| | | |
| |  _|_____  |    _|   |___|  ___  | | | |  _|  _________  |   | |_  |  _____| |  _|___|___|  _  |  _  |  _| | | |_|  _____|_  |_______|_  |
| |_  |   |_  | | |  _|_______|   | | | |___| |  ___  |___  |_| |_  |_|___  | |  _|  _  |  _  |___| |  _|_____| |_  |  _  |      _______|  _|
|   |___|_  |_| | | |_    |   | | |_| |_   ___| |   |___  |_  | | |_________|  _|_____| | |  _|  ___| |  _____    | |___| | | | |  _______| |
| | |   |  _|  _| |_  | | | |___|_  |_  | |  _____|___|  _|_____|  _    |   | |  ___  |  _|_  |_   _| |_  | |   |_|_  |  _| | |_| | |  ___  |
| |___|___|_  |  ___| | |_|___  | |_____|___  | |  _  | |  _  | |_  | |___| | | |  _| |_|  ___|  _|   | |_  | |_|   | | |  _|_____|  _|  _| |
|_  |  _   ___|  _|  ___|  _  | |  _______  | | | |  ___|_  | |  ___|_  |  _|___|   |___  |  ___| | | | |  _|_____|___| |_____  | |_  | |   |
|  _| | | |   |_|  _|  ___| |___| |_   _|  _|___| |  _|  ___| |_  | |  _|_  |  ___|_______| |   | | |_  |_  | |  _   _  |___  | |  _| | | |_|
|_  |___|___|   | | |_  |___    |   |___  |_   ___|_|  _|   | |_____|___  |_|_  |   |  _____| |___| |___|  _| |_  | |___|   | | |  ___| |_  |
|  _|  ___  |_|  _|_  |_  |  _|_| |___  |___  |  _  |_  |_| |_  |  ___  |  _____| | | |  _  |___  |_______|_______|   |  _| | | | |  ___|   |
| |  _|_  |_  |_____  | | |_  |  _| |  _|  ___| |  _  |_  |   |___|  ___|___|  ___| |___| |___  |___   _____  |   |_|  ___| | | |_  |  ___| |
| | |    _  |___  |_____|_  | |_   _|_  | |  ___| |_  | |___| |   |___  |  ___|  ___  | |    _|___  |_  |  _|___|_  |_|   | |  _|  _| |   | |
|___| | |_______| |   |  ___|  ___|  ___|_| |_  |_  |_______| |_|  _  |___|_  |_  |_____| |_  |   | |  _|   |    _| |  _| | | |_____| | |___|
|_____|_____________|___|_________|_______________|_______________|_____________|___________|___|_____|___|___|_______|_____|_________|_____|
