___________
|_    |  _|
|  _| |_  |
|   |___  |
| |_  |  _|
|_|___|___|