_____________________________________________________________________________________________________________________________________________
|   |  _____    |  _____  |   |  _   ___________|  _______   _____  |   |_______    |  _  |___   ___  |  _________    |   |_   _|    _|     |
| | |_  |   | |___|  ___| | |___|  _|  _______  | |___  |  _|    _|___|_____  |  _|___|  _|    _|_   _| |   |_    | |___|___  |  _| |  _| |_|
| |  _|___| | |   |___  |___| |  ___|_  |   | | |_  |   |_  | |_____  |  _____| |___  | |   |_|   |_  | | |_  | | |_____  |___|  _| | | |_  |
| |___   _| |___| |  _______  | |  _____| |___|_______|___| | | |   | |_  | |  ___  | | | |_____| |___|___|  _| |_____  |___  | |   | |  _| |
|___  |_____|_  | |_  |   |_  | | |   |  _|  _______  |  ___|___| |___  | |___|  ___|  _|_____  | |   |  ___|  _|_______|  ___| | |_| |_  | |
| |  _|_   ___  |_  |  _|_  |_| |___|  _|  _|  _    | |___   _  |_  | | |_______|   |_  |  _  |_|_  | |_  | |  _  |  _  | |   | |_____|   | |
|  _|_   _| |  ___| |_____|_______  | |  _|_  | | |_|___  |___|   | |_____  |  ___| | | | |  _|   |_|_  | |  _| |___| | | | | | |  _____|_| |
| |    _|   | |  _  |  ___  |   |  _| |___  |___|_     _| |   |_| |   |   | | | |  ___|___| |  _|___  | | |___  |  ___| |___|_____|  ___  | |
| |_| |_  |___| |___| |_  |___| |_  | |   |_____  | |_______|_____|_| | |_|___|  _|    ___|___|  ___| |  _|_______|   |_   _  |   | |  ___| |
|_  |_  |_____| |  ___|   |_  | | | |___|  ___|  _| |  _  |  ___   ___|_    |  ___| |___     _|  _____|_  |  _   ___|_  | |  _| |___|_  |  _|
|_______|  _  |_____  | |  ___| |  ___|  _|    _|___| | | | | |  _|    ___|_| |   |_  | | |_|  _|_    | | | |  _|  _  | |_|_  |_  |   | |   |
|  _  |  _|  _|  _  |___|_|  ___|_|  ___|  _| |  _______| |_  | |___|_  |  ___| |_  | | |_  | |  ___| |  _| |_  | | | | |  ___|  _| | | |_| |
| |_____| | |  _|  _|  _  |_____________|_  | |_   _|   |_  |_| |  _  |_  |   |_  | |_  | | |___| |  _|_   _|___| |  _|___|   | |  _|___|   |
|_  |  ___|___| | |_  | |_  |   |   |  _   _|___| |  _|_  | |  _|_  |_  |___| |  _|_  |_  |___   _| | |  _|  _  | | |_    | |___| |   |  _|_|
|  _|_   _   ___| |  _|  _____|___|___|___|  _____| |_______|    _| | | |   | | |  _____| |  _|_____|  _|  _|  _| |_  | | | |   |___| | |   |
| |   |_  |___  | |   |  _|   |  ___  |  ___|  _|   |  _  |_  |_  | | | |_|___| |_  |  ___|     |_____|  _| | |_  | |___| | | |_  | | |___| |
| | | | |_  | | | |_| |_|  _|___|  _| |_  |  _  | | | | |_  |___|_____|  ___  |_  |___|   |_| |_________|_  |_____| |  ___|  _|  _| |_  |   |
|  _| |   | | | |_  | |  _|  _|  _  |  _| |_|  _| | |_   _|_  |  ___  |_  |   |  _|_   _|_  | |  _  |___   _|  _______|   |_  |_  |  _|  _|_|
|_  | |_|___  |_  | | | | |   |_  | | |  _____|  _| |  _|  ___| |  _| |___| |_| |_   _|_  |_  |_  | |  _  |  _|_____   _|_  | |  _| |  _|   |
| | |___  | | | |_____| |  _|___  | |___|  _  |_  |_| |  _|   | | |  _|  _  |  ___  |   |_____|  _| | |___|_  |  _____|   | | |_  |_   _| | |
|  _|  ___| | |   |  ___| | |   |_|   |  _| | |   |  _| |  _| |_  |_  | |___| |   |_| | |  _  | | | |___   _| | |  _|   |_| |_  |_  |_|  _| |
| |  _|_________| | |_  | | | |_   _|_|_  | | | | |_  |___| |_______| |_______| | |  _| | | |___| | |  _  |  _| | |  _|_  | | |_  |_  |  _| |
| | |   |  _  | | |_  |_____|_  | |   |   |_____| | |_____  |  ___|  _|  _______|_____| | |  _____| | |___|_____| | |  _|___| |  _| | | |  _|
|_| | |___| | |___  | |   |    _|_| |___|_|   |_   ___  | | |_    |_____|_    |_  |  ___|_  |  _____|  _   _____|  _|_    |___   ___|___|_  |
|  _|___  | | |   |_| | |___| |  _  |  _____|_  |_|   | | |_  |_|    _  |  _|_  | | |  _____|___  |___  |___  |  _|   | | |   |_|   |  _  | |
| |  _____| | | |_  |___| |  _|_  |_|_  |_    |_  | | |_____|_  |_| | |___|_  | | |___|_    |   | |   | |_  |_______| | | | |_____|___| |_  |
|___________|___  |  ___|  _|  _  |   |_  | | | | | |_  |  _  |_____|_     ___| | |    ___|___| | | | | |   |   |  _|___| | |_  |      ___| |
|  ___________  |_|_______  | |  _| |_____| |_  | |_  |___| |_______   _| |  ___|___| |  ___  | |___| | | |_| | |_  |  ___|_  |  _| |_|  ___|
|  _  |  _   _|_______  | | | |_  |_____  |   |_| |  _______  |  _____| | |_  |_   ___| |   | |___  | |___|  _|_  | | |___   _| | | |  _|   |
|_  | |___| |  _   _|  _| | |_  |___|  ___|_|_  |___|   |   | |___  |_______|_____|    _| |_____|  _|_  |  _|  ___| |_  |  _| |_  |___|  _| |
|  _|___  |_____| |  _|_  | | | |  ___| |      _____| | | | |_  |   |  ___    | |  _|_  | |   |  _|   |_  | | |  ___  |___|  _____| |  ___| |
|_____  |___  |  _| |   |_____| | |   |  _| |_|   |  _|___|_  | | |_| |_  | |___|_  | | | | |_____| |_  | | | | |_  |_   _|_  |    _| |  ___|
|  _  |_  |  _|_  | | |_______  | |_|_  | |_  | |___|   |   | | |_  |_  | |___________| | | |  _____| | |___| |___  | |_   _| |_|_   _|___  |
|_  |_____| |     | | |  _|   | | |   |___|  _|___  |_|_  | | |_|   | | |  ___  |  _____|_| | |   |  ___|   |_  | |_  | |_____|   |_____|   |
|  _|  ___| |_| |_|___|  ___|___| | |_______|     |___  |_|_______|_  |___| |  _|___________|_| |___|_   _|_____|  ___| |    ___|_____  | |_|
|_____|   |_  |___   _| |_  |  ___|   |   |  _| | |   |___  |  ___  |_  |   |_____  |    ___|  _|_    |_   _  |_____  |  _|___  |  ___| |   |
|  _  | | |   |   |_______  |_  |  _| | |_____| | | |_|  _  |___  |_  |___|_______| | |_  |  _|    _|_  |___|___  | | | |  _____| |  ___| | |
| |_____|___| | |_  |   |_____| |  _|_____|   | | |_  |_  |_|  ___| |___  |  ___  | | |  _|_  |_|_  | |___  |  ___|  _|_|_  |    _| |  _| | |
|  _  |  _  |_|_  |___|_________|_|   |   | |___|___  | |_____|   | |  ___| |   |___|_|___  | |   | |    _| | |   | |  _  | | |_|  _|_____| |
|___|_____|_________________________|___|___|___________________|___|_________|_____________|___|___|_|_______|_|_____|_____|_______________|
