_____________________________________________________________________________________________________________________________________________
| |  ___    |    _____  |  _____  |  _____  |  ___|  _  |    _|  ___   _|    ___  | |  _____   _  |___   ___    |  _____  |    ___________  |
|  _|  ___|  _|_|  _  |_| | |   | | |_________|  ___| |___|_______|  _|  _|___  | |___|  _  | | | |   |_|  ___| |_____|  _| |___  |_  |  ___|
| | | |  ___|   |_  |_   _|_  |___|___  |  _________  |_   _|  _  |_____  |   | |_______| | | | |___|_  | |  _|_____  | |  _|_  | |  _|___  |
|___| |  ___| |_  | |  _|   |_  |  _  | |_  | |   | |_  | |  _|_____  |  _| |___|    _|  ___| |_     _|___|_   _|  ___|_____  | | |   |  ___|
|  ___| |_____|  _| | |  _|_  |___| | |  _____| | |  ___| | |   |_  | |_  | |   | |_  |_  | |   |_|  _____    |  _|___   _  |___| |_|___  | |
|_  | | |  _____|_  |_| |   | |    _| | |  _____| | |  _  |___|_  |  _|_  |___| |___|_  | |___|_  | |   | | | |___  |  _| |___  |___  | |_  |
|  _|___|___  |   | |  _| | | |_|  ___| | |   |  _| | | |_   _|  _| |   |  ___|  ___  | |_________| | | | | |_____| | |  ___  |___  | |  _| |
| |  _____  |___| | |_  | | |_  |___  |_| | |___|  _| |   | |  _|_____| |_|   | | |  _| |  _    | |___|_  | |  _____| |  _  | |   |___| |  _|
| |___  | |___  | |___  | | |  _|_  |_____|___  |_  |___| | |_______  |_____| |___| | |  ___| |_  |  _____| |_  |_   _|_|  _|  _|_|     |_  |
|  _|  ___|    _|___  | |_| | |  _____  |   |  _| | |   | |  _|    _|___  | |___  | |___|  ___|  _|_  |  ___  |_  |___  |_  |_|   | | |_|  _|
|   | |   | | |  _____| |  _| |_  |   | |_| |_  |_____| | |_____|_   _|   |___  | |_  |  _|  _| |  _| | |_  | |  _|   |_  |  ___| | |_____| |
| |___| | | | | |  _  | | |  _|  _| | |_  |_  |_  |_  | |_  |_  |  _|  _|_|   | |_____| |_________|  _|_  |  _|_____| |  _| |   | | | |  _  |
| |_  | |___| | |  _|___  | |  _  |_|   | |  _  | |  _| |_______|   |_____  | |   |_  |  _______  |___  | |_____  | |___| | | |___| |  _| | |
|___  |_  |  _| | |   |___| | | |_  |_|_____| | | |   |_  |  _  |_| |  _  | | | |_____| |_      |   |  _|___  |  _|_  |  ___| |   | | |  _| |
|  _| | | | |  _|_| | |  ___| |_  | |  _  |   | | | |   |___| | |   | | | | | |_________  |_| |_| | |_   _|  _|___  | | |  _|___| | |_  |  _|
| |  _| | |_|_______| |  _  |___  | |_  | |_|___| |_| | |  _  | | |_| |  _|_|_   ___  |___  | |  _|  _| |  _|_____  | | |_____  |___|___|_  |
| |_  | |_   ___  | | |_  |_  |_  |_____|_____  |_  | |_|  _|_____|  _| |  _  |_  |  _|   |_  | | | |  _|_______  |___|___  |  _______  |   |
|  ___| |  _| |  _| |_  | | |_  |_|  _____  |  ___| |_____|  ___  |_  |  _|_  |___|___  |_  |_| |  _|_________  |_____   _| | |  ___  |___|_|
|___  | | |_   _|  _  | |___  |_  | |_________|  ___|  _____|  ___|  _|_|   |_______  |_|  _|  _| |  _   _|   |_  |   |_  | | |_  | |_____  |
|   |___|_  | | | | | |___  |_|  _| |  _  |   |_______|   | |_  |  _______| |  _  | |_____|  _|___|_  |_____|_  | | |_|  _| |  _|___  | |   |
| |_________| | | | |___  |_____|  ___|   | |_    |_   _|_  |  _| |  _  |  _|_  |___  |  _  |  _______|  _  | | | |_  |_____|  _________| | |
| |  _|   |  _| | |_  |   |  _  |___  | |_| |  _|_  |   |  _| | | | | | | |  ___|   |___| | | |  ___  |_  | | | |___  |  _  |_   _|  _  | | |
| |_   _|___|_________| |___|  _|___  |_____|_  |  _|_| |_|  _|___| |_____| |_   _| |  _____| | |   | |  _|_  |_______| |___|  _|  _|  _| |_|
|   |___  |   |  _______|_  | |_    | |   |  ___|_   ___|  _|  _  |_  |   | |  _|_  |___   _|___| |___| |   |_______  |_  |  ___| |  _|___  |
| |_  |_____|___|___   _  | |_  | | | | |___|    _| |   | |  _| |_____| |___|  _  | |  ___|  _____|___  |_|   |  _  |_  |  _|  ___|_  |  _  |
|  _|_  |   |  _  |  _|  _|   |___| | |___  | |_____| | |___|    _|  _  |___  |  _|_|  ___|_____  |  ___|  _|_| | |_____|___|_  |  ___| |_  |
|_|   | | |___|_____| | |_  | |   | |_|  ___| |___  | |_  |  _|_____| |___  |_|_    | |  _________|_  | |  _  |_  |   |  _______|_  |  _  | |
|  _|  _|_   _  | |  ___   _|_| |___|  _|   |___  | | | |___|___   ___|   |_    |_|_  |_  |___   _____|  ___|_  | | | | |  _  |  ___|_|  _| |
| |___|   |___| | | |   |_|   | |    _|_  |_________|_  |  ___  | |  ___|_  | | |   |___|___  | |  ___  | |  _  |___|___|   |_| |  _____| | |
|  _____|___  | |___| |_____|___| |_|   |_______|  _____|_  |_   _|_  |___  |_| | | |  _   _|___| |   |___| | | | |    _| | |  _|_  |  ___  |
| |     |  ___|  _  | | |  _    | |  _|___  |  ___|  ___  |_  |_|   |___  |_  |___| |_  |_________| |___  | |  _| | |_____| |_  |  _| |   |_|
| |_| | | |_   _|   | |  _|  _| |___  | |  _| | |  _  |___  |_  | |_  |  _|_______  |  _|  ___  | | |  _| | |_  | |_   ___|   | | |_  | |_  |
|_____| |_  | | | |_| |___|_  |_  |_____|_  | | | | |___  |_____| |  _|_______  | | |_____| |  _| | | |  ___|_______| |   | | | |_  |_|  _| |
|  ___|_  | |_  | |  _|  _  | | |_________  | |_______  |_  |  ___|_______  |  _|___  |   | | |  _| | | | |  _____  | | |___| | |  _|  _|  _|
| |  _____| |  _| |_____| | | |  _   ___|  _|_  |  _____|  _|___  | |  _  | |_____  |___|_  | |_  | |_____| |  _  |___|_  |_  | |_____  |_  |
| | |_  |  _|_  |___   _|  ___|___|_  |  _|   | |_______|   |   | | | |_  |___    | |_    | |___  |___  |  _|_  | |  ___|_  | | |   | | |  _|
| | |  _|___  |_____|___  |  _  |   |  ___| |___|   |   | | | |___| |_  |_______| |_  | | |___  |_  |   | |  ___| | |   |  _|_|___| |  _|_  |
| | |_   _  |_________  |_|_  |___| |_|  ___|  ___| | | | |_____   ___| |  _|   |_  | |_|_____  |  _| | |___|   |_  | |_  |  _   _| |  ___| |
| |_  |_|  ___  |___  |___  |_  | |_  |___  | |  ___| | |_|   |___|  ___|   | | |  _| |  ___  |_|_  | |___|  _|_  | | |___|_  |_____|_|  _  |
|_________|_______________|_________|_________|_______|_____|_______|_____|___|_____|_______|_______|___________|___|___________________|___|
